//MAP CONVERTED BY dmm2tgm.py THIS HEADER COMMENT PREVENTS RECONVERSION, DO NOT REMOVE
"aO" = (
/obj/structure/fireplace{
	dir = 8
	},
/turf/open/floor/wood,
/area/ruin/space/has_grav/powered)
"bG" = (
/obj/structure/chair/wood,
/turf/open/floor/grass/snow/safe,
/area/ruin/space/has_grav/glade)
"bJ" = (
/turf/closed/indestructible/wood,
/area/ruin/space/has_grav/powered)
"bM" = (
/obj/machinery/power/solar_control,
/turf/open/floor/mineral/plastitanium,
/area/ruin/space/has_grav/powered)
"bV" = (
/obj/structure/netcable{
	dir = 4
	},
/turf/open/floor/grass/snow/safe,
/area/ruin/space/has_grav/glade)
"cr" = (
/obj/effect/spawner/structure/window/plasma/reinforced/plastitanium,
/turf/open/floor/plating,
/area/ruin/space/has_grav/powered)
"dN" = (
/obj/structure/rack,
/turf/open/floor/mineral/plastitanium,
/area/ruin/space/has_grav/powered)
"eg" = (
/obj/structure/netcable/end,
/turf/open/floor/grass/snow/safe,
/area/ruin/space/has_grav/glade)
"ek" = (
/obj/structure/flora/tree/pine,
/obj/structure/netcable/end{
	dir = 8
	},
/turf/open/floor/grass/snow/safe,
/area/ruin/space/has_grav/glade)
"eD" = (
/obj/structure/chair/wood{
	dir = 4
	},
/turf/open/floor/grass/snow/safe,
/area/ruin/space/has_grav/glade)
"fP" = (
/obj/machinery/computer{
	dir = 1
	},
/turf/open/floor/mineral/plastitanium,
/area/ruin/space/has_grav/powered)
"gM" = (
/turf/open/floor/mineral/plastitanium,
/area/ruin/space/has_grav/powered)
"gN" = (
/obj/structure/chair/sofa/red/right,
/turf/open/floor/mineral/plastitanium,
/area/ruin/space/has_grav/powered)
"hp" = (
/obj/docking_port/mobile,
/turf/template_noop,
/area/template_noop)
"hO" = (
/obj/structure/flora/grass/both,
/turf/open/floor/grass/snow/safe,
/area/ruin/space/has_grav/glade)
"io" = (
/obj/structure/flora/tree/pine,
/obj/structure/netcable{
	dir = 4
	},
/turf/open/floor/grass/snow/safe,
/area/ruin/space/has_grav/glade)
"jy" = (
/obj/structure/flora/tree/pine,
/obj/structure/flora/tree/pine,
/turf/open/floor/grass/snow/safe,
/area/ruin/space/has_grav/glade)
"jE" = (
/obj/machinery/light/directional/south,
/turf/open/floor/mineral/plastitanium,
/area/ruin/space/has_grav/powered)
"kl" = (
/obj/structure/flora/grass/both,
/obj/structure/flora/tree/pine,
/turf/open/floor/grass/snow/safe,
/area/ruin/space/has_grav/glade)
"kN" = (
/obj/structure/flora/tree/pine,
/turf/open/floor/grass/snow/safe,
/area/ruin/space/has_grav/glade)
"ln" = (
/obj/machinery/light/directional/north,
/turf/open/floor/mineral/plastitanium,
/area/ruin/space/has_grav/powered)
"mK" = (
/turf/open/floor/plating/snowed/smoothed,
/area/ruin/space/has_grav/glade)
"oh" = (
/obj/structure/lattice/catwalk,
/obj/structure/cable{
	icon_state = "1-2"
	},
/turf/open/floor/grass/snow/safe,
/area/ruin/space/has_grav/glade)
"oQ" = (
/obj/structure/chair/wood{
	dir = 8
	},
/turf/open/floor/grass/snow/safe,
/area/ruin/space/has_grav/glade)
"pJ" = (
/obj/structure/table/wood,
/obj/item/flashlight/flare/torch,
/turf/open/floor/wood,
/area/ruin/space/has_grav/powered)
"rr" = (
/obj/structure/netcable/end{
	dir = 1
	},
/turf/open/floor/grass/snow/safe,
/area/ruin/space/has_grav/glade)
"to" = (
/turf/closed/indestructible/overic,
/area/template_noop)
"tW" = (
/obj/structure/lattice/catwalk,
/obj/structure/cable{
	icon_state = "2-4"
	},
/obj/structure/cable{
	icon_state = "1-2"
	},
/obj/structure/cable{
	icon_state = "2-8"
	},
/turf/open/floor/grass/snow/safe,
/area/ruin/space/has_grav/glade)
"uJ" = (
/obj/structure/chair/sofa/red,
/turf/open/floor/mineral/plastitanium,
/area/ruin/space/has_grav/powered)
"ve" = (
/turf/closed/mineral/snowmountain,
/area/ruin/space/has_grav/glade)
"vs" = (
/obj/structure/flora/grass/brown,
/obj/structure/flora/tree/pine,
/turf/open/floor/grass/snow/safe,
/area/ruin/space/has_grav/glade)
"wb" = (
/obj/structure/table/wood,
/obj/item/paper,
/turf/open/floor/wood,
/area/ruin/space/has_grav/powered)
"wx" = (
/obj/structure/destructible/tribal_torch/lit,
/turf/open/floor/wood,
/area/ruin/space/has_grav/powered)
"yx" = (
/obj/structure/chair/wood{
	dir = 8
	},
/turf/open/floor/wood,
/area/ruin/space/has_grav/powered)
"zI" = (
/turf/closed/indestructible/overic,
/area/ruin/space/has_grav/glade)
"CA" = (
/turf/open/floor/grass/snow/safe,
/area/ruin/space/has_grav/glade)
"CZ" = (
/obj/machinery/hydroponics/constructable,
/turf/open/floor/mineral/plastitanium,
/area/ruin/space/has_grav/powered)
"DS" = (
/obj/structure/table/wood,
/obj/item/paper/crumpled,
/obj/item/paper/crumpled{
	pixel_y = 11;
	pixel_x = -7
	},
/turf/open/floor/wood,
/area/ruin/space/has_grav/powered)
"Ew" = (
/obj/machinery/power/smes,
/turf/open/floor/mineral/plastitanium,
/area/ruin/space/has_grav/powered)
"FA" = (
/obj/structure/flora/grass/brown,
/turf/open/floor/grass/snow/safe,
/area/ruin/space/has_grav/glade)
"FT" = (
/turf/open/floor/glass/reinforced,
/area/ruin/space/has_grav/powered)
"HL" = (
/obj/structure/mineral_door/wood,
/turf/open/floor/wood,
/area/ruin/space/has_grav/powered)
"Iv" = (
/obj/structure/flora/grass/both,
/obj/structure/flora/grass/brown,
/turf/open/floor/grass/snow/safe,
/area/ruin/space/has_grav/glade)
"IH" = (
/obj/structure/flora/grass/both,
/obj/structure/flora/grass/both,
/turf/open/floor/grass/snow/safe,
/area/ruin/space/has_grav/glade)
"JX" = (
/obj/structure/netcable/end{
	dir = 8
	},
/turf/open/floor/grass/snow/safe,
/area/ruin/space/has_grav/glade)
"My" = (
/obj/machinery/door/airlock/gold/glass,
/turf/open/floor/mineral/plastitanium,
/area/ruin/space/has_grav/powered)
"PU" = (
/turf/open/indestructible/overic,
/area/ruin/space/has_grav/glade)
"Qh" = (
/turf/open/indestructible/overic/floor,
/area/ruin/space/has_grav/glade)
"Ra" = (
/obj/structure/barricade/wooden/crude/snow,
/turf/open/floor/grass/snow/safe,
/area/ruin/space/has_grav/glade)
"Rl" = (
/obj/structure/overic_structure/computer{
	light_range = 0.5;
	density = 1
	},
/turf/open/indestructible/overic/floor,
/area/ruin/space/has_grav/glade)
"Ry" = (
/obj/structure/flora/grass/brown,
/turf/open/indestructible/overic/floor,
/area/ruin/space/has_grav/glade)
"RX" = (
/turf/open/floor/wood,
/area/ruin/space/has_grav/powered)
"Sm" = (
/obj/effect/turf_decal/solarpanel,
/obj/machinery/power/solar/fake,
/turf/open/floor/plating,
/area/ruin/space/has_grav/glade)
"Ui" = (
/obj/structure/chair/wood{
	dir = 1
	},
/turf/open/floor/grass/snow/safe,
/area/ruin/space/has_grav/glade)
"Ut" = (
/obj/structure/cable{
	icon_state = "0-2"
	},
/obj/machinery/power/tracker,
/turf/open/floor/plating,
/area/ruin/space/has_grav/glade)
"Uv" = (
/obj/item/flashlight/lantern/lamp_of_silence,
/turf/open/floor/plating/snowed/smoothed,
/area/ruin/space/has_grav/glade)
"VP" = (
/obj/structure/lattice/catwalk,
/obj/structure/cable{
	icon_state = "1-2"
	},
/obj/structure/cable{
	icon_state = "2-4"
	},
/obj/structure/cable{
	icon_state = "2-8"
	},
/turf/open/floor/grass/snow/safe,
/area/ruin/space/has_grav/glade)
"VX" = (
/obj/machinery/quantumpad,
/turf/open/floor/glass/reinforced,
/area/ruin/space/has_grav/powered)
"XL" = (
/turf/closed/indestructible/reinforced,
/area/ruin/space/has_grav/powered)
"YK" = (
/obj/structure/netcable,
/turf/open/floor/grass/snow/safe,
/area/ruin/space/has_grav/glade)
"ZA" = (
/obj/structure/chair/sofa/red/left,
/turf/open/floor/mineral/plastitanium,
/area/ruin/space/has_grav/powered)
"ZO" = (
/turf/template_noop,
/area/template_noop)

(1,1,1) = {"
hp
ZO
ZO
ZO
ZO
ZO
ZO
ZO
ZO
ZO
ZO
ZO
ZO
ZO
ve
ve
ve
ve
ve
ve
ve
ve
ve
ve
ve
ve
ve
ve
ve
ve
ZO
ZO
ZO
ZO
ZO
ZO
ZO
ZO
ZO
ZO
ZO
ZO
ZO
ZO
ZO
ZO
ZO
ZO
ZO
ZO
"}
(2,1,1) = {"
ZO
ZO
ZO
ZO
ZO
ZO
ZO
ZO
ZO
ZO
ZO
ZO
ve
ve
ve
ve
ve
ve
ve
ve
ve
ve
ve
ve
ve
ve
ve
ve
ve
ve
ZO
ZO
ZO
ZO
ZO
ZO
ZO
ZO
ZO
ZO
ZO
ZO
ZO
ZO
ZO
ZO
ZO
ZO
ZO
ZO
"}
(3,1,1) = {"
ZO
ZO
ZO
ZO
ZO
ZO
ZO
ZO
ZO
ZO
ve
ve
ve
ve
CA
CA
CA
CA
CA
CA
CA
CA
CA
CA
CA
CA
CA
CA
ve
ve
ve
ve
ZO
ZO
ZO
ZO
ZO
ZO
ZO
ZO
ZO
ZO
ZO
ZO
ZO
ZO
ZO
ZO
ZO
ZO
"}
(4,1,1) = {"
ZO
ZO
ZO
ZO
ZO
ZO
ZO
ZO
ZO
ve
ve
ve
CA
CA
CA
CA
CA
CA
FA
kN
CA
CA
hO
CA
CA
kN
CA
CA
CA
ve
ve
ve
ZO
ZO
ZO
ZO
ZO
ZO
ZO
ZO
ZO
ZO
ZO
ZO
ZO
ZO
ZO
ZO
ZO
ZO
"}
(5,1,1) = {"
ZO
ZO
ZO
ZO
ZO
ZO
ZO
ZO
ZO
ve
ve
CA
CA
CA
CA
CA
CA
CA
CA
CA
CA
CA
hO
CA
CA
CA
hO
CA
CA
ve
ve
ve
ZO
ZO
ZO
ZO
ZO
ZO
ZO
ZO
ZO
ZO
ZO
ZO
ZO
ZO
ZO
ZO
ZO
ZO
"}
(6,1,1) = {"
ZO
ZO
ZO
ZO
ZO
ZO
ZO
ZO
ve
ve
CA
CA
CA
CA
kN
hO
CA
CA
hO
CA
CA
hO
CA
CA
CA
hO
CA
hO
Iv
CA
CA
ve
ve
ve
ZO
ZO
ZO
ZO
ZO
ZO
ZO
ZO
ZO
ZO
ZO
ZO
ZO
ZO
ZO
ZO
"}
(7,1,1) = {"
ZO
ZO
ZO
ZO
ZO
ZO
ZO
ZO
ve
ve
CA
CA
CA
CA
CA
CA
CA
FA
CA
CA
CA
CA
CA
CA
CA
CA
CA
CA
CA
CA
CA
CA
ve
ve
ve
ve
ZO
ZO
ZO
ZO
ZO
ZO
ZO
ZO
ZO
ZO
ZO
ZO
ZO
ZO
"}
(8,1,1) = {"
ZO
ZO
ZO
ZO
ZO
ZO
ZO
ZO
ve
ve
CA
CA
hO
CA
CA
CA
CA
CA
CA
CA
CA
CA
CA
CA
vs
CA
CA
CA
CA
CA
kN
CA
CA
ve
ve
ve
ZO
ZO
ZO
ZO
ZO
ZO
ZO
ZO
ZO
ZO
ZO
ZO
ZO
ZO
"}
(9,1,1) = {"
ZO
ZO
ZO
ZO
ZO
ZO
ZO
ve
ve
ve
CA
kN
CA
CA
CA
vs
CA
CA
CA
hO
CA
CA
CA
CA
CA
CA
CA
CA
CA
CA
FA
CA
FA
CA
ve
ve
ve
ZO
ZO
ZO
ZO
ZO
ZO
ZO
ZO
ZO
ZO
ZO
ZO
ZO
"}
(10,1,1) = {"
ZO
ZO
ZO
ZO
ZO
ZO
ZO
ve
ve
CA
CA
CA
CA
CA
CA
CA
CA
CA
CA
CA
CA
kN
CA
XL
cr
cr
cr
XL
CA
CA
CA
CA
FA
CA
ve
bJ
bJ
bJ
bJ
bJ
bJ
bJ
ZO
ZO
ZO
ZO
ZO
ZO
ZO
ZO
"}
(11,1,1) = {"
ZO
ZO
ZO
ZO
ZO
ZO
ZO
ve
ve
CA
CA
IH
CA
CA
Sm
CA
Sm
CA
Sm
CA
CA
CA
XL
XL
dN
dN
dN
XL
XL
CA
CA
CA
CA
hO
CA
bJ
wx
wb
DS
pJ
pJ
bJ
ZO
ZO
ZO
ZO
ZO
ZO
ZO
ZO
"}
(12,1,1) = {"
ZO
ZO
ZO
ZO
ZO
ZO
ZO
ve
ve
CA
CA
CA
CA
CA
Sm
CA
Sm
CA
Sm
CA
CA
XL
XL
ln
gM
gM
gM
jE
XL
XL
CA
CA
CA
CA
CA
bJ
RX
RX
yx
RX
RX
bJ
ZO
ZO
ZO
ZO
ZO
ZO
ZO
ZO
"}
(13,1,1) = {"
ZO
ZO
ZO
ZO
ZO
ZO
ZO
ve
ve
CA
CA
CA
CA
CA
Sm
CA
Sm
CA
Sm
CA
CA
XL
bM
gM
FT
FT
FT
gN
fP
XL
FA
FA
CA
CA
CA
HL
RX
RX
RX
RX
RX
bJ
ZO
ZO
ZO
ZO
ZO
ZO
ZO
ZO
"}
(14,1,1) = {"
ZO
ZO
ZO
ZO
ZO
ZO
ZO
ve
ve
CA
CA
hO
CA
Ut
tW
oh
VP
oh
VP
oh
oh
My
gM
gM
FT
VX
FT
uJ
fP
XL
CA
CA
CA
vs
CA
bJ
RX
RX
RX
RX
RX
bJ
ZO
ZO
ZO
ZO
ZO
ZO
ZO
ZO
"}
(15,1,1) = {"
ZO
ZO
ZO
ZO
ZO
ZO
ZO
ve
ve
ve
CA
CA
CA
CA
Sm
CA
Sm
CA
Sm
CA
CA
XL
Ew
gM
FT
FT
FT
ZA
fP
XL
CA
CA
CA
CA
CA
bJ
wx
RX
aO
RX
wx
bJ
ZO
ZO
ZO
ZO
ZO
ZO
ZO
ZO
"}
(16,1,1) = {"
ZO
ZO
ZO
ZO
ZO
ZO
ZO
ve
ve
ve
ve
CA
CA
CA
Sm
CA
Sm
CA
Sm
CA
CA
XL
XL
ln
gM
gM
gM
jE
XL
XL
CA
CA
CA
CA
ve
bJ
bJ
bJ
bJ
bJ
bJ
bJ
ZO
ZO
ZO
ZO
ZO
ZO
ZO
ZO
"}
(17,1,1) = {"
ZO
ZO
ZO
ZO
ZO
ZO
ZO
ZO
ZO
ve
ve
ve
CA
kN
Sm
CA
Sm
CA
Sm
CA
CA
CA
XL
XL
CZ
CZ
CZ
XL
XL
CA
CA
kN
CA
CA
ve
ve
ZO
ZO
ZO
ZO
ZO
ZO
ZO
ZO
ZO
ZO
ZO
ZO
ZO
ZO
"}
(18,1,1) = {"
ZO
ZO
ZO
ZO
ZO
ZO
ZO
ZO
ZO
ZO
ve
ve
CA
CA
CA
CA
CA
CA
hO
CA
CA
CA
CA
XL
cr
cr
cr
XL
CA
CA
CA
CA
CA
CA
ve
ve
ZO
ZO
ZO
ZO
ZO
ZO
ZO
ZO
ZO
ZO
ZO
ZO
ZO
ZO
"}
(19,1,1) = {"
ZO
ZO
ZO
ZO
ZO
ZO
ZO
ZO
ZO
ZO
ve
ve
CA
CA
CA
CA
CA
CA
hO
CA
CA
CA
CA
kN
CA
CA
CA
CA
CA
CA
CA
CA
hO
CA
ve
ve
ZO
ZO
ZO
ZO
ZO
ZO
ZO
ZO
ZO
ZO
ZO
ZO
ZO
ZO
"}
(20,1,1) = {"
ZO
ZO
ZO
ZO
ZO
ZO
ZO
ZO
ZO
ZO
ve
ve
ve
CA
CA
CA
hO
CA
CA
CA
CA
CA
hO
CA
hO
CA
hO
CA
CA
CA
kl
CA
CA
ve
ve
ve
ZO
ZO
ZO
ZO
ZO
ZO
ZO
ZO
ZO
ZO
ZO
ZO
ZO
ZO
"}
(21,1,1) = {"
ZO
ZO
ZO
ZO
ZO
ZO
ZO
ZO
ZO
ZO
ZO
ve
ve
ve
CA
CA
hO
CA
CA
CA
CA
CA
hO
CA
CA
hO
CA
kl
CA
CA
CA
CA
CA
ve
ve
ZO
ZO
ZO
ZO
ZO
ZO
ZO
ZO
ZO
ZO
ZO
ZO
ZO
ZO
ZO
"}
(22,1,1) = {"
ZO
ZO
ZO
ZO
ZO
ZO
ZO
ZO
ZO
ZO
ZO
ZO
ve
ve
ve
CA
CA
CA
kN
CA
CA
CA
hO
hO
CA
CA
CA
CA
CA
CA
CA
CA
ve
ve
ve
ZO
ZO
ZO
ZO
ZO
ZO
ZO
ZO
ZO
ZO
ZO
ZO
ZO
ZO
ZO
"}
(23,1,1) = {"
ZO
ZO
ZO
ZO
ZO
ZO
ZO
ZO
ZO
ZO
ZO
ZO
ve
ve
ve
CA
CA
CA
CA
CA
CA
CA
hO
CA
CA
hO
CA
CA
CA
CA
ve
ve
ve
ve
ZO
ZO
ZO
ZO
ZO
ZO
ZO
ZO
ZO
ZO
ZO
ZO
ZO
ZO
ZO
ZO
"}
(24,1,1) = {"
ZO
ZO
ZO
ZO
ZO
ZO
ZO
ZO
ZO
ZO
ZO
ZO
ve
ve
ve
ve
ve
ve
ve
ve
ve
ve
ve
ve
ve
ve
ve
ve
ve
ve
ve
ve
ve
ZO
ZO
ZO
ZO
ZO
ZO
ZO
ZO
ZO
ZO
ZO
ZO
ZO
ZO
ZO
ZO
ZO
"}
(25,1,1) = {"
ZO
ZO
ZO
ZO
ZO
ZO
ZO
ZO
ZO
ZO
ZO
ZO
ZO
ve
ve
ve
ve
ve
ve
ve
ve
ve
ve
ve
ve
ve
ve
ve
ve
ve
ve
ZO
ZO
ZO
ZO
ZO
ZO
ZO
ZO
ZO
ZO
ZO
ZO
ZO
ZO
ZO
ZO
ZO
ZO
ZO
"}
(26,1,1) = {"
ZO
ZO
ZO
ZO
ZO
ZO
ZO
ZO
ZO
ZO
ZO
ZO
ZO
ZO
ZO
ZO
ZO
ve
ve
ve
ve
ve
ve
ve
ve
ve
ve
ve
ve
ve
ve
ZO
ZO
ZO
ZO
ZO
ZO
ZO
ZO
ZO
ZO
ZO
ZO
ZO
ZO
ZO
ZO
ZO
ZO
ZO
"}
(27,1,1) = {"
ZO
ZO
ZO
ZO
ZO
ZO
ZO
ZO
ZO
ZO
ve
ZO
ZO
ve
ve
ve
ve
ve
ve
ve
ve
ve
ve
ve
ve
ve
ve
ve
ve
ve
ZO
ZO
ZO
ZO
ZO
ZO
ZO
ZO
ZO
ZO
ZO
ZO
ZO
ZO
ZO
ZO
ZO
ZO
ZO
ZO
"}
(28,1,1) = {"
ZO
ZO
ZO
ZO
ve
ve
ve
ve
ve
ve
ve
ve
ve
ve
ve
ve
ve
ve
ve
ve
ve
ve
ve
ve
ve
ve
ve
ve
ve
ve
ve
ZO
ZO
ZO
ZO
ZO
ZO
ZO
ZO
ZO
ZO
ZO
ZO
ZO
ZO
ZO
ZO
ZO
ZO
ZO
"}
(29,1,1) = {"
ZO
ZO
ZO
ve
ve
ve
ve
ve
ve
ve
ve
ve
ve
ve
ve
ve
ve
zI
zI
zI
zI
ve
ve
ve
ve
ve
ve
ve
ve
ve
ve
ve
ZO
ZO
ZO
ZO
ZO
ZO
ZO
ZO
ZO
ZO
ZO
ZO
ZO
ZO
ZO
ZO
ZO
ZO
"}
(30,1,1) = {"
ZO
ZO
ve
ve
ve
ve
CA
CA
ve
CA
CA
CA
kN
CA
kN
kN
kN
zI
Qh
Rl
Qh
Ry
CA
kN
CA
CA
ve
ve
ve
ve
ve
ve
ve
ve
ZO
ZO
ZO
ZO
ZO
ZO
ZO
ZO
ZO
ZO
ZO
ZO
ZO
ZO
ZO
ZO
"}
(31,1,1) = {"
ZO
ZO
ve
ve
ve
CA
CA
CA
CA
CA
kN
kN
CA
CA
CA
kN
hO
hO
CA
Qh
CA
hO
CA
CA
CA
CA
CA
CA
CA
ve
ve
ve
ve
ve
ZO
ZO
ZO
ZO
ZO
ZO
ZO
ZO
ZO
ZO
ZO
ZO
ZO
ZO
ZO
ZO
"}
(32,1,1) = {"
ZO
ZO
ve
ve
CA
CA
CA
CA
CA
kN
CA
hO
kl
kN
CA
CA
kN
CA
CA
FA
CA
FA
CA
CA
CA
CA
hO
hO
CA
CA
CA
ve
ve
ve
ve
ve
ZO
ZO
ZO
ZO
ZO
ZO
ZO
ZO
ZO
ZO
ZO
ZO
ZO
ZO
"}
(33,1,1) = {"
ZO
ve
ve
ve
ve
CA
CA
kN
CA
CA
CA
CA
CA
CA
kN
CA
CA
CA
kN
CA
CA
kN
CA
CA
kN
CA
CA
CA
CA
CA
CA
CA
CA
ve
ve
ve
ZO
ZO
ZO
ZO
ZO
ZO
ZO
ZO
ZO
ZO
ZO
ZO
ZO
ZO
"}
(34,1,1) = {"
ZO
ve
ve
ve
CA
CA
CA
CA
hO
CA
kN
kN
CA
CA
CA
CA
CA
CA
kN
CA
CA
CA
CA
CA
CA
CA
CA
CA
CA
CA
CA
CA
hO
ve
ve
ve
ZO
ZO
ZO
ZO
ZO
ZO
ZO
ZO
ZO
ZO
ZO
ZO
ZO
ZO
"}
(35,1,1) = {"
ZO
zI
zI
zI
zI
eg
CA
kl
hO
CA
CA
CA
CA
eD
CA
CA
CA
CA
CA
CA
kN
CA
CA
hO
CA
CA
CA
CA
CA
FA
CA
CA
CA
ve
ve
bJ
bJ
bJ
bJ
bJ
bJ
bJ
ZO
ZO
ZO
ZO
ZO
ZO
ZO
ZO
"}
(36,1,1) = {"
ve
zI
zI
zI
zI
CA
CA
kN
kN
CA
CA
CA
CA
CA
CA
CA
CA
CA
CA
CA
CA
CA
hO
hO
CA
CA
CA
CA
CA
CA
CA
CA
CA
ve
ve
bJ
wx
wb
DS
pJ
pJ
bJ
ZO
ZO
ZO
ZO
ZO
ZO
ZO
ZO
"}
(37,1,1) = {"
ve
zI
zI
zI
zI
YK
YK
eg
CA
CA
kN
CA
CA
CA
CA
CA
CA
CA
CA
CA
CA
CA
mK
CA
CA
CA
mK
CA
CA
CA
CA
mK
mK
mK
Ra
bJ
RX
RX
yx
RX
RX
bJ
ZO
ZO
ZO
ZO
ZO
ZO
ZO
ZO
"}
(38,1,1) = {"
ve
zI
zI
zI
zI
eg
CA
CA
jy
CA
bG
CA
CA
Uv
CA
CA
Ui
CA
CA
CA
CA
CA
CA
CA
JX
CA
CA
CA
CA
mK
mK
mK
CA
mK
mK
HL
RX
RX
RX
RX
RX
bJ
ZO
ZO
ZO
ZO
ZO
ZO
ZO
ZO
"}
(39,1,1) = {"
ZO
zI
zI
zI
zI
kN
CA
CA
jy
kN
kN
CA
CA
CA
CA
CA
CA
CA
CA
CA
CA
CA
JX
CA
io
CA
CA
CA
CA
CA
CA
CA
CA
CA
ve
bJ
RX
RX
RX
RX
RX
bJ
ZO
ZO
ZO
ZO
ZO
ZO
ZO
ZO
"}
(40,1,1) = {"
ZO
ve
zI
ve
CA
CA
CA
hO
hO
CA
CA
CA
CA
CA
CA
CA
FA
FA
CA
kN
CA
CA
bV
CA
bV
CA
CA
CA
CA
CA
CA
CA
CA
ve
ve
bJ
wx
RX
aO
RX
wx
bJ
ZO
ZO
ZO
ZO
ZO
ZO
ZO
ZO
"}
(41,1,1) = {"
ZO
ve
ve
ve
CA
CA
hO
CA
CA
kN
CA
CA
CA
oQ
CA
CA
CA
CA
CA
CA
CA
kN
bV
CA
bV
CA
CA
CA
CA
kN
CA
CA
CA
ve
ve
bJ
bJ
bJ
bJ
bJ
bJ
bJ
ZO
ZO
ZO
ZO
ZO
ZO
ZO
ZO
"}
(42,1,1) = {"
ZO
ve
ve
ve
CA
CA
CA
CA
kN
kN
CA
kN
CA
hO
CA
CA
CA
CA
CA
CA
rr
YK
zI
zI
zI
zI
YK
YK
eg
CA
CA
CA
CA
ve
ve
ZO
ZO
ZO
ZO
ZO
ZO
ZO
ZO
ZO
ZO
ZO
ZO
ZO
ZO
ZO
"}
(43,1,1) = {"
ZO
ve
ve
ve
ve
CA
CA
CA
CA
hO
CA
ek
CA
CA
CA
CA
kN
hO
CA
hO
CA
kN
zI
PU
zI
hO
CA
hO
CA
hO
hO
CA
ve
ve
ve
ZO
ZO
ZO
ZO
ZO
ZO
ZO
ZO
ZO
ZO
ZO
ZO
ZO
ZO
ZO
"}
(44,1,1) = {"
ZO
ZO
ve
ve
ve
ve
ve
CA
CA
kN
kN
bV
CA
kN
CA
kN
CA
CA
hO
hO
CA
CA
PU
PU
zI
hO
CA
CA
CA
CA
CA
CA
ve
ve
ZO
ZO
ZO
ZO
ZO
ZO
ZO
ZO
ZO
ZO
ZO
ZO
ZO
ZO
ZO
ZO
"}
(45,1,1) = {"
ZO
ZO
ve
ve
ve
ve
ve
CA
CA
CA
CA
bV
CA
kN
kN
CA
CA
kN
CA
CA
CA
CA
PU
PU
zI
CA
CA
CA
CA
CA
ve
ve
ve
ZO
ZO
ZO
ZO
ZO
ZO
ZO
ZO
ZO
ZO
ZO
ZO
ZO
ZO
ZO
ZO
ZO
"}
(46,1,1) = {"
ZO
ZO
ZO
ZO
ve
ve
ve
ve
ve
zI
zI
zI
zI
zI
CA
kN
kN
CA
CA
CA
CA
CA
ve
ve
ve
ve
ve
ve
ve
ve
ve
ve
ve
ZO
ZO
ZO
ZO
ZO
ZO
ZO
ZO
ZO
ZO
ZO
ZO
ZO
ZO
ZO
ZO
ZO
"}
(47,1,1) = {"
ZO
ZO
ZO
ZO
ZO
ZO
ve
ve
ve
zI
zI
zI
zI
zI
YK
YK
YK
eg
ve
ve
ve
ve
ve
ve
ve
ve
ve
ve
ve
ve
ve
ve
ve
ZO
ZO
ZO
ZO
ZO
ZO
ZO
ZO
ZO
ZO
ZO
ZO
ZO
ZO
ZO
ZO
ZO
"}
(48,1,1) = {"
ZO
ZO
ZO
ZO
ZO
ZO
ZO
ZO
ZO
to
zI
zI
zI
zI
ve
ve
ve
ve
ve
ve
ve
ve
ve
ve
ve
ve
ve
ve
ve
ve
ve
ZO
ZO
ZO
ZO
ZO
ZO
ZO
ZO
ZO
ZO
ZO
ZO
ZO
ZO
ZO
ZO
ZO
ZO
ZO
"}
(49,1,1) = {"
ZO
ZO
ZO
ZO
ZO
ZO
ZO
ZO
ZO
to
to
zI
ve
ve
ve
ve
ve
ve
ve
ZO
ZO
ZO
ZO
ZO
ZO
ZO
ZO
ZO
ZO
ZO
ZO
ZO
ZO
ZO
ZO
ZO
ZO
ZO
ZO
ZO
ZO
ZO
ZO
ZO
ZO
ZO
ZO
ZO
ZO
ZO
"}
(50,1,1) = {"
ZO
ZO
ZO
ZO
ZO
ZO
ZO
ZO
ZO
ZO
ZO
ZO
ZO
ZO
ZO
ZO
ZO
ZO
ZO
ZO
ZO
ZO
ZO
ZO
ZO
ZO
ZO
ZO
ZO
ZO
ZO
ZO
ZO
ZO
ZO
ZO
ZO
ZO
ZO
ZO
ZO
ZO
ZO
ZO
ZO
ZO
ZO
ZO
ZO
ZO
"}
