//MAP CONVERTED BY dmm2tgm.py THIS HEADER COMMENT PREVENTS RECONVERSION, DO NOT REMOVE
"ad" = (
/turf/closed/indestructible/overic,
/area/hangar)
"ae" = (
/obj/structure/table/overic,
/turf/open/indestructible/overic,
/area/hangar)
"af" = (
/obj/machinery/door/overic/public{
	dir = 4
	},
/turf/open/indestructible/overic/floor,
/area/hangar)
"ag" = (
/obj/structure/netcable,
/turf/open/indestructible/overic,
/area/hangar)
"ai" = (
/turf/open/indestructible/overic/hangar,
/area/hangar)
"aj" = (
/turf/open/indestructible/overic/floor,
/area/hangar)
"al" = (
/turf/open/indestructible/overic/hangar/middle,
/area/hangar)
"am" = (
/turf/open/indestructible/overic/energy,
/area/hangar)
"an" = (
/obj/structure/netcable,
/turf/open/indestructible/overic/floor,
/area/hangar)
"ap" = (
/turf/open/indestructible/overic/hangar{
	dir = 5
	},
/area/hangar)
"as" = (
/obj/structure/overic_light/floor/hangar,
/turf/open/indestructible/overic/floor,
/area/hangar)
"ax" = (
/obj/machinery/elevator_call_button{
	pixel_y = 25
	},
/obj/effect/landmark/outpost/elevator_machine,
/turf/open/indestructible/overic,
/area/hangar)
"ay" = (
/obj/machinery/door/overic,
/turf/open/indestructible/overic/floor,
/area/hangar)
"aB" = (
/obj/structure/overic_light/directional/west,
/turf/open/indestructible/overic,
/area/hangar)
"aC" = (
/obj/structure/netcable{
	dir = 1
	},
/turf/open/indestructible/overic/floor,
/area/hangar)
"aD" = (
/obj/structure/overic_light/floor/hangar,
/turf/open/indestructible/overic,
/area/hangar)
"aE" = (
/turf/open/indestructible/overic/hangar{
	dir = 4
	},
/area/hangar)
"aG" = (
/turf/open/indestructible/overic,
/area/hangar)
"aH" = (
/obj/structure/overic_light/directional/north,
/turf/open/indestructible/overic/floor,
/area/hangar)
"aI" = (
/turf/open/indestructible/overic/hangar{
	dir = 1
	},
/area/hangar)
"aJ" = (
/obj/structure/netcable/end,
/turf/open/indestructible/overic/hangar{
	dir = 1
	},
/area/hangar)
"aK" = (
/obj/structure/overic_light/directional/north,
/obj/structure/table/overic,
/turf/open/indestructible/overic,
/area/hangar)
"aN" = (
/turf/open/indestructible/overic/hangar{
	dir = 8
	},
/area/hangar)
"aP" = (
/obj/structure/overic_light/directional/south,
/obj/structure/table/overic,
/turf/open/indestructible/overic,
/area/hangar)
"aX" = (
/obj/structure/netcable/end{
	dir = 1
	},
/turf/open/indestructible/overic/hangar,
/area/hangar)
"aZ" = (
/turf/template_noop,
/area/template_noop)
"bQ" = (
/obj/machinery/door/overic{
	dir = 4
	},
/turf/open/indestructible/overic/floor,
/area/hangar)
"eJ" = (
/obj/structure/overic_light/directional/east,
/turf/open/indestructible/overic/floor,
/area/hangar)
"io" = (
/obj/structure/overic_light/directional/south,
/turf/open/indestructible/overic/floor,
/area/hangar)
"jJ" = (
/obj/structure/netcable{
	dir = 1
	},
/turf/open/indestructible/overic,
/area/hangar)
"mX" = (
/obj/machinery/door/airlock,
/obj/effect/landmark/outpost/elevator_machine,
/turf/open/indestructible/overic,
/area/hangar)
"pi" = (
/turf/open/indestructible/overic/hangar{
	dir = 6
	},
/area/hangar)
"qa" = (
/turf/open/indestructible/overic/hangar{
	dir = 9
	},
/area/hangar)
"uQ" = (
/obj/structure/overic_light/directional/east,
/turf/open/indestructible/overic,
/area/hangar)
"vM" = (
/obj/effect/landmark/outpost/hangar_dock,
/turf/open/indestructible/overic/hangar{
	dir = 10
	},
/area/hangar)
"xE" = (
/obj/effect/landmark/outpost/elevator,
/turf/open/indestructible/overic/energy,
/area/hangar)

(1,1,1) = {"
ad
ad
ad
ad
ad
ad
ad
ad
ad
ad
ad
ad
ad
ad
ad
ad
ad
ad
ad
ad
ad
ad
ad
ad
ad
ad
ad
ad
ad
ad
"}
(2,1,1) = {"
ad
ad
ad
ad
ad
ad
ad
ad
ad
ad
ad
ad
ad
ad
ad
ad
ad
ad
ad
ad
ad
ad
ad
ad
ad
ad
ad
ad
ad
ad
"}
(3,1,1) = {"
ad
ad
aG
aG
aG
aG
aG
aG
aG
aG
aG
aG
aG
aG
aG
aG
aG
aG
aG
aG
aG
aG
aG
aG
aG
aG
aG
aG
ad
ad
"}
(4,1,1) = {"
ad
ad
aG
aj
aj
aj
aj
aj
aj
aj
aj
aj
aj
aj
aj
aj
aj
aj
aj
aj
aj
aj
aj
aj
aj
aj
aj
aG
ad
ad
"}
(5,1,1) = {"
ad
ad
aG
aj
aj
aj
aj
aj
aj
aj
aj
aj
aj
aj
aj
aj
aj
aj
aj
aj
aj
aj
aj
aj
aj
aj
aj
aG
ad
ad
"}
(6,1,1) = {"
ad
ad
aG
aj
aj
qa
aN
aN
aN
aN
aN
aN
aN
aN
aN
aN
aN
aN
aN
aN
aN
aN
aN
aN
vM
aj
aj
aG
ad
ad
"}
(7,1,1) = {"
ad
ad
aG
aj
aj
aI
al
al
al
al
al
al
al
al
al
al
al
al
al
al
al
al
al
al
ai
aj
aj
aG
ad
ad
"}
(8,1,1) = {"
ad
ad
ag
an
an
aJ
al
al
al
al
al
al
al
al
al
al
al
al
al
al
al
al
al
al
aX
aC
aC
jJ
ad
ad
"}
(9,1,1) = {"
ad
ad
aG
aj
aj
aI
al
al
al
al
al
al
al
al
al
al
al
al
al
al
al
al
al
al
ai
aj
aj
aG
ad
ad
"}
(10,1,1) = {"
ad
ad
aG
aj
as
aI
al
al
al
al
al
al
al
al
al
al
al
al
al
al
al
al
al
al
ai
as
aj
aG
ad
ad
"}
(11,1,1) = {"
ad
ad
aG
aj
aj
aI
al
al
al
al
al
al
al
al
al
al
al
al
al
al
al
al
al
al
ai
aj
aj
aG
ad
ad
"}
(12,1,1) = {"
ad
ad
aG
aj
aj
aI
al
al
al
al
al
al
al
al
al
al
al
al
al
al
al
al
al
al
ai
aj
aj
aG
ad
ad
"}
(13,1,1) = {"
ad
ad
ag
an
an
aJ
al
al
al
al
al
al
al
al
al
al
al
al
al
al
al
al
al
al
aX
aC
aC
jJ
ad
ad
"}
(14,1,1) = {"
ad
ad
aG
aj
aj
aI
al
al
al
al
al
al
al
al
al
al
al
al
al
al
al
al
al
al
ai
aj
aj
aG
ad
ad
"}
(15,1,1) = {"
ad
ad
aG
aj
aj
aI
al
al
al
al
al
al
al
al
al
al
al
al
al
al
al
al
al
al
ai
aj
aj
aG
ad
ad
"}
(16,1,1) = {"
ad
ad
aG
aj
aj
aI
al
al
al
al
al
al
al
al
al
al
al
al
al
al
al
al
al
al
ai
aj
aj
aG
ad
ad
"}
(17,1,1) = {"
ad
ad
aG
aj
aj
aI
al
al
al
al
al
al
al
al
al
al
al
al
al
al
al
al
al
al
ai
aj
aj
aG
ad
ad
"}
(18,1,1) = {"
ad
ad
ag
an
aC
aJ
al
al
al
al
al
al
al
al
al
al
al
al
al
al
al
al
al
al
aX
aC
aC
jJ
ad
ad
"}
(19,1,1) = {"
ad
ad
aG
aj
aj
aI
al
al
al
al
al
al
al
al
al
al
al
al
al
al
al
al
al
al
ai
aj
aj
aG
ad
ad
"}
(20,1,1) = {"
ad
ad
aG
aj
as
aI
al
al
al
al
al
al
al
al
al
al
al
al
al
al
al
al
al
al
ai
as
aj
aG
ad
ad
"}
(21,1,1) = {"
ad
ad
aG
aj
aj
aI
al
al
al
al
al
al
al
al
al
al
al
al
al
al
al
al
al
al
ai
aj
aj
aG
ad
ad
"}
(22,1,1) = {"
ad
ad
aG
aj
aj
aI
al
al
al
al
al
al
al
al
al
al
al
al
al
al
al
al
al
al
ai
aj
aj
aG
ad
ad
"}
(23,1,1) = {"
ad
ad
ag
an
an
aJ
al
al
al
al
al
al
al
al
al
al
al
al
al
al
al
al
al
al
aX
aC
aC
jJ
ad
ad
"}
(24,1,1) = {"
ad
ad
aG
aj
aj
aI
al
al
al
al
al
al
al
al
al
al
al
al
al
al
al
al
al
al
ai
aj
aj
aG
ad
ad
"}
(25,1,1) = {"
ad
ad
aG
aj
aj
aI
al
al
al
al
al
al
al
al
al
al
al
al
al
al
al
al
al
al
ai
aj
aj
aG
ad
ad
"}
(26,1,1) = {"
ad
ad
aG
aj
aj
aI
al
al
al
al
al
al
al
al
al
al
al
al
al
al
al
al
al
al
ai
aj
aj
aG
ad
ad
"}
(27,1,1) = {"
ad
ad
aG
aj
aj
aI
al
al
al
al
al
al
al
al
al
al
al
al
al
al
al
al
al
al
ai
aj
aj
aG
ad
ad
"}
(28,1,1) = {"
ad
ad
ag
an
an
aJ
al
al
al
al
al
al
al
al
al
al
al
al
al
al
al
al
al
al
aX
aC
aC
jJ
ad
ad
"}
(29,1,1) = {"
ad
ad
aG
aj
aj
aI
al
al
al
al
al
al
al
al
al
al
al
al
al
al
al
al
al
al
ai
aj
aj
aG
ad
ad
"}
(30,1,1) = {"
ad
ad
aG
aj
as
aI
al
al
al
al
al
al
al
al
al
al
al
al
al
al
al
al
al
al
ai
as
aj
aG
ad
ad
"}
(31,1,1) = {"
ad
ad
aG
aj
aj
aI
al
al
al
al
al
al
al
al
al
al
al
al
al
al
al
al
al
al
ai
aj
aj
aG
ad
ad
"}
(32,1,1) = {"
ad
ad
aG
aj
aj
aI
al
al
al
al
al
al
al
al
al
al
al
al
al
al
al
al
al
al
ai
aj
aj
aG
ad
ad
"}
(33,1,1) = {"
ad
ad
ag
an
an
aJ
al
al
al
al
al
al
al
al
al
al
al
al
al
al
al
al
al
al
aX
aC
aC
jJ
ad
ad
"}
(34,1,1) = {"
ad
ad
aG
aj
aj
aI
al
al
al
al
al
al
al
al
al
al
al
al
al
al
al
al
al
al
ai
aj
aj
aG
ad
ad
"}
(35,1,1) = {"
ad
ad
aG
aj
aj
aI
al
al
al
al
al
al
al
al
al
al
al
al
al
al
al
al
al
al
ai
aj
aj
aG
ad
ad
"}
(36,1,1) = {"
ad
ad
aG
aj
aj
aI
al
al
al
al
al
al
al
al
al
al
al
al
al
al
al
al
al
al
ai
aj
aj
aG
ad
ad
"}
(37,1,1) = {"
ad
ad
aG
aj
aj
aI
al
al
al
al
al
al
al
al
al
al
al
al
al
al
al
al
al
al
ai
aj
aj
aG
ad
ad
"}
(38,1,1) = {"
ad
ad
ag
an
an
aJ
al
al
al
al
al
al
al
al
al
al
al
al
al
al
al
al
al
al
aX
aC
aC
jJ
ad
ad
"}
(39,1,1) = {"
ad
ad
aG
aj
aj
aI
al
al
al
al
al
al
al
al
al
al
al
al
al
al
al
al
al
al
ai
aj
aj
aG
ad
ad
"}
(40,1,1) = {"
ad
ad
aG
aj
as
aI
al
al
al
al
al
al
al
al
al
al
al
al
al
al
al
al
al
al
ai
as
aj
aG
ad
ad
"}
(41,1,1) = {"
ad
ad
aG
aj
aj
aI
al
al
al
al
al
al
al
al
al
al
al
al
al
al
al
al
al
al
ai
aj
aj
aG
ad
ad
"}
(42,1,1) = {"
ad
ad
aG
aj
aj
aI
al
al
al
al
al
al
al
al
al
al
al
al
al
al
al
al
al
al
ai
aj
aj
aG
ad
ad
"}
(43,1,1) = {"
ad
ad
ag
an
an
aJ
al
al
al
al
al
al
al
al
al
al
al
al
al
al
al
al
al
al
aX
aC
aC
jJ
ad
ad
"}
(44,1,1) = {"
ad
ad
aG
aj
aj
aI
al
al
al
al
al
al
al
al
al
al
al
al
al
al
al
al
al
al
ai
aj
aj
aG
ad
ad
"}
(45,1,1) = {"
ad
ad
aG
aj
aj
aI
al
al
al
al
al
al
al
al
al
al
al
al
al
al
al
al
al
al
ai
aj
aj
aG
ad
ad
"}
(46,1,1) = {"
ad
ad
aG
aj
aj
aI
al
al
al
al
al
al
al
al
al
al
al
al
al
al
al
al
al
al
ai
aj
aj
aG
ad
ad
"}
(47,1,1) = {"
ad
ad
aG
aj
aj
aI
al
al
al
al
al
al
al
al
al
al
al
al
al
al
al
al
al
al
ai
aj
aj
aG
ad
ad
"}
(48,1,1) = {"
ad
ad
ag
an
an
aJ
al
al
al
al
al
al
al
al
al
al
al
al
al
al
al
al
al
al
aX
aC
aC
jJ
ad
ad
"}
(49,1,1) = {"
ad
ad
aG
aj
aj
aI
al
al
al
al
al
al
al
al
al
al
al
al
al
al
al
al
al
al
ai
aj
aj
aG
ad
ad
"}
(50,1,1) = {"
ad
ad
aG
aj
as
aI
al
al
al
al
al
al
al
al
al
al
al
al
al
al
al
al
al
al
ai
as
aj
aG
ad
ad
"}
(51,1,1) = {"
ad
ad
aG
aj
aj
aI
al
al
al
al
al
al
al
al
al
al
al
al
al
al
al
al
al
al
ai
aj
aj
aG
ad
ad
"}
(52,1,1) = {"
ad
ad
aG
aj
aj
aI
al
al
al
al
al
al
al
al
al
al
al
al
al
al
al
al
al
al
ai
aj
aj
aG
ad
ad
"}
(53,1,1) = {"
ad
ad
ag
an
an
aJ
al
al
al
al
al
al
al
al
al
al
al
al
al
al
al
al
al
al
aX
aC
aC
jJ
ad
ad
"}
(54,1,1) = {"
ad
ad
aG
aj
aj
aI
al
al
al
al
al
al
al
al
al
al
al
al
al
al
al
al
al
al
ai
aj
aj
aG
ad
ad
"}
(55,1,1) = {"
ad
ad
aG
aj
aj
aI
al
al
al
al
al
al
al
al
al
al
al
al
al
al
al
al
al
al
ai
aj
aj
aG
ad
ad
"}
(56,1,1) = {"
ad
ad
aG
aj
aj
aI
al
al
al
al
al
al
al
al
al
al
al
al
al
al
al
al
al
al
ai
aj
aj
aG
ad
ad
"}
(57,1,1) = {"
ad
ad
aG
aj
aj
aI
al
al
al
al
al
al
al
al
al
al
al
al
al
al
al
al
al
al
ai
aj
aj
aG
ad
ad
"}
(58,1,1) = {"
ad
ad
ag
an
an
aJ
al
al
al
al
al
al
al
al
al
al
al
al
al
al
al
al
al
al
aX
aC
aC
jJ
ad
ad
"}
(59,1,1) = {"
ad
ad
aG
aj
aj
aI
al
al
al
al
al
al
al
al
al
al
al
al
al
al
al
al
al
al
ai
aj
aj
aG
ad
ad
"}
(60,1,1) = {"
ad
ad
aG
aj
as
aI
al
al
al
al
al
al
al
al
al
al
al
al
al
al
al
al
al
al
ai
as
aj
aG
ad
ad
"}
(61,1,1) = {"
ad
ad
aG
aj
aj
ap
aE
aE
aE
aE
aE
aE
aE
aE
aE
aE
aE
aE
aE
aE
aE
aE
aE
aE
pi
aj
aj
aG
ad
ad
"}
(62,1,1) = {"
ad
ad
aG
aj
aj
aj
aj
aj
aj
aj
aj
aj
aj
aj
aj
aj
aj
aj
aj
aj
aj
aj
aj
aj
aj
aj
aj
aG
ad
ad
"}
(63,1,1) = {"
ad
ad
aG
aj
aj
aj
aj
aj
aj
aj
aj
aj
aj
aj
aj
aj
aj
aj
aj
aj
aj
aj
aj
aj
aj
aj
aj
aG
ad
ad
"}
(64,1,1) = {"
ad
ad
aG
aG
aG
aG
aD
aG
aG
aG
aG
aG
aG
aG
aG
aG
aG
aG
aG
aG
aG
aG
aG
aD
aG
aG
aG
aG
ad
ad
"}
(65,1,1) = {"
ad
ad
ad
ad
ad
ad
ad
ad
ad
ad
ad
ad
ad
ad
af
ad
af
ad
ad
ad
ad
ad
ad
ad
ad
ad
ad
ad
ad
ad
"}
(66,1,1) = {"
ad
ad
ad
ad
ad
ad
ad
ad
ad
ad
ae
ae
ae
aG
aj
aj
aj
aG
ae
ae
ae
ad
ad
ad
ad
ad
ad
ad
ad
ad
"}
(67,1,1) = {"
aZ
aZ
aZ
aZ
aZ
aZ
aZ
aZ
ad
ad
aK
aj
aj
aj
aj
aj
aj
aj
aj
aj
aP
ad
ad
aZ
aZ
aZ
aZ
aZ
aZ
aZ
"}
(68,1,1) = {"
aZ
aZ
aZ
aZ
aZ
aZ
aZ
aZ
ad
ad
ae
aj
aG
aG
aG
uQ
aG
aG
aG
aj
ae
ad
ad
aZ
aZ
aZ
aZ
aZ
aZ
aZ
"}
(69,1,1) = {"
aZ
aZ
aZ
aZ
aZ
aZ
aZ
ad
ad
ad
aG
aj
aG
ad
ad
ad
ad
ad
ax
aj
aG
ad
ad
ad
aZ
aZ
aZ
aZ
aZ
aZ
"}
(70,1,1) = {"
aZ
aZ
aZ
aZ
aZ
aZ
aZ
ad
aj
ay
aj
aj
aj
ad
am
am
xE
mX
aj
aj
aj
ay
aj
ad
aZ
aZ
aZ
aZ
aZ
aZ
"}
(71,1,1) = {"
aZ
aZ
aZ
aZ
aZ
aZ
aZ
ad
aH
ad
aj
aj
io
ad
am
am
am
mX
aj
aj
aj
ad
io
ad
aZ
aZ
aZ
aZ
aZ
aZ
"}
(72,1,1) = {"
aZ
aZ
aZ
aZ
aZ
aZ
aZ
ad
aj
ay
aj
aj
aj
ad
am
am
am
mX
aj
aj
aj
ay
aj
ad
aZ
aZ
aZ
aZ
aZ
aZ
"}
(73,1,1) = {"
aZ
aZ
aZ
aZ
aZ
aZ
aZ
ad
ad
ad
aG
aj
aG
ad
ad
ad
ad
ad
aG
aj
aG
ad
ad
ad
aZ
aZ
aZ
aZ
aZ
aZ
"}
(74,1,1) = {"
aZ
aZ
aZ
aZ
aZ
aZ
aZ
aZ
ad
ad
ae
aj
aG
aG
aG
aB
aG
aG
aG
aj
ae
ad
ad
aZ
aZ
aZ
aZ
aZ
aZ
aZ
"}
(75,1,1) = {"
aZ
aZ
aZ
aZ
aZ
aZ
aZ
aZ
ad
ad
aK
aj
aj
aj
aj
aj
aj
aj
aj
aj
aP
ad
ad
aZ
aZ
aZ
aZ
aZ
aZ
aZ
"}
(76,1,1) = {"
aZ
aZ
aZ
aZ
aZ
aZ
aZ
aZ
ad
ad
ae
ae
ae
aG
aj
aj
aj
aG
ae
ae
ae
ad
ad
aZ
aZ
aZ
aZ
aZ
aZ
aZ
"}
(77,1,1) = {"
aZ
aZ
aZ
aZ
aZ
aZ
aZ
aZ
ad
ad
ad
ad
ad
ad
bQ
ad
bQ
ad
ad
ad
ad
ad
ad
aZ
aZ
aZ
aZ
aZ
aZ
aZ
"}
(78,1,1) = {"
aZ
aZ
aZ
aZ
aZ
aZ
aZ
aZ
ad
ad
ad
ad
ad
ad
aj
eJ
aj
ad
ad
ad
ad
ad
ad
aZ
aZ
aZ
aZ
aZ
aZ
aZ
"}
(79,1,1) = {"
aZ
aZ
aZ
aZ
aZ
aZ
aZ
aZ
aZ
aZ
aZ
aZ
aZ
ad
ad
ad
ad
ad
aZ
aZ
aZ
aZ
aZ
aZ
aZ
aZ
aZ
aZ
aZ
aZ
"}
