//MAP CONVERTED BY dmm2tgm.py THIS HEADER COMMENT PREVENTS RECONVERSION, DO NOT REMOVE
"ac" = (
/obj/machinery/door/overic,
/turf/open/indestructible/overic/floor,
/area/hangar)
"ad" = (
/obj/structure/overic_light/directional/south,
/obj/structure/table/overic,
/turf/open/indestructible/overic,
/area/hangar)
"al" = (
/turf/open/indestructible/overic/hangar{
	dir = 5
	},
/area/hangar)
"am" = (
/obj/structure/overic_light/directional/west,
/turf/open/indestructible/overic,
/area/hangar)
"ao" = (
/obj/structure/overic_light/directional/north,
/obj/structure/table/overic,
/turf/open/indestructible/overic,
/area/hangar)
"ap" = (
/obj/structure/netcable/end{
	dir = 1
	},
/turf/open/indestructible/overic/hangar,
/area/hangar)
"av" = (
/obj/structure/netcable/end,
/turf/open/indestructible/overic/hangar{
	dir = 1
	},
/area/hangar)
"ax" = (
/turf/open/indestructible/overic/energy,
/area/hangar)
"ay" = (
/obj/structure/table/overic,
/turf/open/indestructible/overic,
/area/hangar)
"az" = (
/obj/structure/netcable,
/turf/open/indestructible/overic/floor,
/area/hangar)
"aA" = (
/turf/open/indestructible/overic/hangar/middle,
/area/hangar)
"aB" = (
/turf/open/indestructible/overic/hangar{
	dir = 8
	},
/area/hangar)
"aC" = (
/obj/structure/overic_light/floor/hangar,
/turf/open/indestructible/overic/floor,
/area/hangar)
"aE" = (
/obj/effect/landmark/outpost/elevator,
/turf/open/indestructible/overic/energy,
/area/hangar)
"aH" = (
/turf/template_noop,
/area/template_noop)
"aJ" = (
/turf/open/indestructible/overic/hangar,
/area/hangar)
"aL" = (
/obj/structure/overic_light/directional/south,
/turf/open/indestructible/overic/floor,
/area/hangar)
"aM" = (
/turf/open/indestructible/overic/hangar{
	dir = 1
	},
/area/hangar)
"aN" = (
/turf/open/indestructible/overic/hangar{
	dir = 4
	},
/area/hangar)
"aO" = (
/turf/open/indestructible/overic/hangar{
	dir = 6
	},
/area/hangar)
"aP" = (
/turf/open/indestructible/overic/floor,
/area/hangar)
"aT" = (
/obj/machinery/door/overic/public{
	dir = 4
	},
/turf/open/indestructible/overic/floor,
/area/hangar)
"aY" = (
/obj/machinery/door/airlock,
/obj/effect/landmark/outpost/elevator_machine,
/turf/open/indestructible/overic,
/area/hangar)
"aZ" = (
/turf/closed/indestructible/overic,
/area/hangar)
"eG" = (
/obj/structure/overic_light/directional/east,
/turf/open/indestructible/overic/floor,
/area/hangar)
"gu" = (
/obj/machinery/door/overic{
	dir = 4
	},
/turf/open/indestructible/overic/floor,
/area/hangar)
"jk" = (
/obj/structure/overic_light/directional/east,
/turf/open/indestructible/overic,
/area/hangar)
"nM" = (
/obj/machinery/elevator_call_button{
	pixel_y = 25
	},
/obj/effect/landmark/outpost/elevator_machine,
/turf/open/indestructible/overic,
/area/hangar)
"qz" = (
/obj/structure/netcable,
/turf/open/indestructible/overic,
/area/hangar)
"rQ" = (
/turf/open/indestructible/overic,
/area/hangar)
"tk" = (
/obj/structure/overic_light/directional/north,
/turf/open/indestructible/overic/floor,
/area/hangar)
"Gy" = (
/turf/open/indestructible/overic/hangar{
	dir = 9
	},
/area/hangar)
"TL" = (
/obj/effect/landmark/outpost/hangar_dock,
/turf/open/indestructible/overic/hangar{
	dir = 10
	},
/area/hangar)

(1,1,1) = {"
aZ
aZ
aZ
aZ
aZ
aZ
aZ
aZ
aZ
aZ
aZ
aZ
aZ
aZ
aZ
aZ
aZ
aZ
aZ
aZ
aZ
aZ
aZ
aZ
aZ
aZ
aZ
aZ
aZ
aZ
"}
(2,1,1) = {"
aZ
aZ
aZ
aZ
aZ
aZ
aZ
aZ
aZ
aZ
aZ
aZ
aZ
aZ
aZ
aZ
aZ
aZ
aZ
aZ
aZ
aZ
aZ
aZ
aZ
aZ
aZ
aZ
aZ
aZ
"}
(3,1,1) = {"
aZ
aZ
rQ
rQ
rQ
rQ
rQ
rQ
rQ
rQ
rQ
rQ
rQ
rQ
rQ
rQ
rQ
rQ
rQ
rQ
rQ
rQ
rQ
rQ
rQ
rQ
rQ
rQ
aZ
aZ
"}
(4,1,1) = {"
aZ
aZ
rQ
aP
aP
aP
aP
aP
aP
aP
aP
aP
aP
aP
aP
aP
aP
aP
aP
aP
aP
aP
aP
aP
aP
aP
aP
rQ
aZ
aZ
"}
(5,1,1) = {"
aZ
aZ
rQ
aP
aP
aP
aP
aP
aP
aP
aP
aP
aP
aP
aP
aP
aP
aP
aP
aP
aP
aP
aP
aP
aP
aP
aP
rQ
aZ
aZ
"}
(6,1,1) = {"
aZ
aZ
rQ
aP
aP
Gy
aB
aB
aB
aB
aB
aB
aB
aB
aB
aB
aB
aB
aB
aB
aB
aB
aB
aB
TL
aP
aP
rQ
aZ
aZ
"}
(7,1,1) = {"
aZ
aZ
rQ
aP
aP
aM
aA
aA
aA
aA
aA
aA
aA
aA
aA
aA
aA
aA
aA
aA
aA
aA
aA
aA
aJ
aP
aP
rQ
aZ
aZ
"}
(8,1,1) = {"
aZ
aZ
rQ
aP
aC
aM
aA
aA
aA
aA
aA
aA
aA
aA
aA
aA
aA
aA
aA
aA
aA
aA
aA
aA
aJ
aC
aP
rQ
aZ
aZ
"}
(9,1,1) = {"
aZ
aZ
rQ
aP
aP
aM
aA
aA
aA
aA
aA
aA
aA
aA
aA
aA
aA
aA
aA
aA
aA
aA
aA
aA
aJ
aP
aP
rQ
aZ
aZ
"}
(10,1,1) = {"
aZ
aZ
rQ
aP
aP
aM
aA
aA
aA
aA
aA
aA
aA
aA
aA
aA
aA
aA
aA
aA
aA
aA
aA
aA
aJ
aP
aP
rQ
aZ
aZ
"}
(11,1,1) = {"
aZ
aZ
qz
az
az
av
aA
aA
aA
aA
aA
aA
aA
aA
aA
aA
aA
aA
aA
aA
aA
aA
aA
aA
ap
az
az
qz
aZ
aZ
"}
(12,1,1) = {"
aZ
aZ
rQ
aP
aP
aM
aA
aA
aA
aA
aA
aA
aA
aA
aA
aA
aA
aA
aA
aA
aA
aA
aA
aA
aJ
aP
aP
rQ
aZ
aZ
"}
(13,1,1) = {"
aZ
aZ
rQ
aP
aP
aM
aA
aA
aA
aA
aA
aA
aA
aA
aA
aA
aA
aA
aA
aA
aA
aA
aA
aA
aJ
aP
aP
rQ
aZ
aZ
"}
(14,1,1) = {"
aZ
aZ
rQ
aP
aP
aM
aA
aA
aA
aA
aA
aA
aA
aA
aA
aA
aA
aA
aA
aA
aA
aA
aA
aA
aJ
aP
aP
rQ
aZ
aZ
"}
(15,1,1) = {"
aZ
aZ
rQ
aP
aP
aM
aA
aA
aA
aA
aA
aA
aA
aA
aA
aA
aA
aA
aA
aA
aA
aA
aA
aA
aJ
aP
aP
rQ
aZ
aZ
"}
(16,1,1) = {"
aZ
aZ
rQ
aP
aP
aM
aA
aA
aA
aA
aA
aA
aA
aA
aA
aA
aA
aA
aA
aA
aA
aA
aA
aA
aJ
aP
aP
rQ
aZ
aZ
"}
(17,1,1) = {"
aZ
aZ
rQ
aP
aP
aM
aA
aA
aA
aA
aA
aA
aA
aA
aA
aA
aA
aA
aA
aA
aA
aA
aA
aA
aJ
aP
aP
rQ
aZ
aZ
"}
(18,1,1) = {"
aZ
aZ
rQ
aP
aC
aM
aA
aA
aA
aA
aA
aA
aA
aA
aA
aA
aA
aA
aA
aA
aA
aA
aA
aA
aJ
aC
aP
rQ
aZ
aZ
"}
(19,1,1) = {"
aZ
aZ
rQ
aP
aP
aM
aA
aA
aA
aA
aA
aA
aA
aA
aA
aA
aA
aA
aA
aA
aA
aA
aA
aA
aJ
aP
aP
rQ
aZ
aZ
"}
(20,1,1) = {"
aZ
aZ
qz
az
az
av
aA
aA
aA
aA
aA
aA
aA
aA
aA
aA
aA
aA
aA
aA
aA
aA
aA
aA
ap
az
az
qz
aZ
aZ
"}
(21,1,1) = {"
aZ
aZ
rQ
aP
aP
aM
aA
aA
aA
aA
aA
aA
aA
aA
aA
aA
aA
aA
aA
aA
aA
aA
aA
aA
aJ
aP
aP
rQ
aZ
aZ
"}
(22,1,1) = {"
aZ
aZ
rQ
aP
aP
aM
aA
aA
aA
aA
aA
aA
aA
aA
aA
aA
aA
aA
aA
aA
aA
aA
aA
aA
aJ
aP
aP
rQ
aZ
aZ
"}
(23,1,1) = {"
aZ
aZ
rQ
aP
aP
aM
aA
aA
aA
aA
aA
aA
aA
aA
aA
aA
aA
aA
aA
aA
aA
aA
aA
aA
aJ
aP
aP
rQ
aZ
aZ
"}
(24,1,1) = {"
aZ
aZ
rQ
aP
aP
aM
aA
aA
aA
aA
aA
aA
aA
aA
aA
aA
aA
aA
aA
aA
aA
aA
aA
aA
aJ
aP
aP
rQ
aZ
aZ
"}
(25,1,1) = {"
aZ
aZ
rQ
aP
aP
al
aN
aN
aN
aN
aN
aN
aN
aN
aN
aN
aN
aN
aN
aN
aN
aN
aN
aN
aO
aP
aP
rQ
aZ
aZ
"}
(26,1,1) = {"
aZ
aZ
rQ
aP
aP
aP
aP
aP
aP
aP
aP
aP
aP
aP
aP
aP
aP
aP
aP
aP
aP
aP
aP
aP
aP
aP
aP
rQ
aZ
aZ
"}
(27,1,1) = {"
aZ
aZ
rQ
aP
aP
aP
aP
aP
aP
aP
aC
aP
aP
aP
aP
aP
aP
aP
aP
aP
aC
aP
aP
aP
aP
aP
aP
rQ
aZ
aZ
"}
(28,1,1) = {"
aZ
aZ
rQ
rQ
rQ
rQ
rQ
rQ
rQ
rQ
rQ
rQ
rQ
rQ
aP
aP
aP
rQ
rQ
rQ
rQ
rQ
rQ
rQ
rQ
rQ
rQ
rQ
aZ
aZ
"}
(29,1,1) = {"
aZ
aZ
aZ
aZ
aZ
aZ
aZ
aZ
aZ
aZ
aZ
aZ
aZ
aZ
aT
aZ
aT
aZ
aZ
aZ
aZ
aZ
aZ
aZ
aZ
aZ
aZ
aZ
aZ
aZ
"}
(30,1,1) = {"
aZ
aZ
aZ
aZ
aZ
aZ
aZ
aZ
aZ
aZ
ay
ay
ay
rQ
aP
aP
aP
rQ
ay
ay
ay
aZ
aZ
aZ
aZ
aZ
aZ
aZ
aZ
aZ
"}
(31,1,1) = {"
aH
aH
aH
aH
aH
aH
aH
aH
aZ
aZ
ao
aP
aP
aP
aP
aP
aP
aP
aP
aP
ad
aZ
aZ
aH
aH
aH
aH
aH
aH
aH
"}
(32,1,1) = {"
aH
aH
aH
aH
aH
aH
aH
aH
aZ
aZ
ay
aP
rQ
rQ
rQ
jk
rQ
rQ
rQ
aP
ay
aZ
aZ
aH
aH
aH
aH
aH
aH
aH
"}
(33,1,1) = {"
aH
aH
aH
aH
aH
aH
aH
aZ
aZ
aZ
rQ
aP
rQ
aZ
aZ
aZ
aZ
aZ
nM
aP
rQ
aZ
aZ
aZ
aH
aH
aH
aH
aH
aH
"}
(34,1,1) = {"
aH
aH
aH
aH
aH
aH
aH
aZ
aP
ac
aP
aP
aP
aZ
ax
ax
aE
aY
aP
aP
aP
ac
aP
aZ
aH
aH
aH
aH
aH
aH
"}
(35,1,1) = {"
aH
aH
aH
aH
aH
aH
aH
aZ
tk
aZ
aP
aP
aL
aZ
ax
ax
ax
aY
aP
aP
aP
aZ
aL
aZ
aH
aH
aH
aH
aH
aH
"}
(36,1,1) = {"
aH
aH
aH
aH
aH
aH
aH
aZ
aP
ac
aP
aP
aP
aZ
ax
ax
ax
aY
aP
aP
aP
ac
aP
aZ
aH
aH
aH
aH
aH
aH
"}
(37,1,1) = {"
aH
aH
aH
aH
aH
aH
aH
aZ
aZ
aZ
rQ
aP
rQ
aZ
aZ
aZ
aZ
aZ
rQ
aP
rQ
aZ
aZ
aZ
aH
aH
aH
aH
aH
aH
"}
(38,1,1) = {"
aH
aH
aH
aH
aH
aH
aH
aH
aZ
aZ
ay
aP
rQ
rQ
rQ
am
rQ
rQ
rQ
aP
ay
aZ
aZ
aH
aH
aH
aH
aH
aH
aH
"}
(39,1,1) = {"
aH
aH
aH
aH
aH
aH
aH
aH
aZ
aZ
ao
aP
aP
aP
aP
aP
aP
aP
aP
aP
ad
aZ
aZ
aH
aH
aH
aH
aH
aH
aH
"}
(40,1,1) = {"
aH
aH
aH
aH
aH
aH
aH
aH
aZ
aZ
ay
ay
ay
rQ
aP
aP
aP
rQ
ay
ay
ay
aZ
aZ
aH
aH
aH
aH
aH
aH
aH
"}
(41,1,1) = {"
aH
aH
aH
aH
aH
aH
aH
aH
aZ
aZ
aZ
aZ
aZ
aZ
gu
aZ
gu
aZ
aZ
aZ
aZ
aZ
aZ
aH
aH
aH
aH
aH
aH
aH
"}
(42,1,1) = {"
aH
aH
aH
aH
aH
aH
aH
aH
aZ
aZ
aZ
aZ
aZ
aZ
aP
eG
aP
aZ
aZ
aZ
aZ
aZ
aZ
aH
aH
aH
aH
aH
aH
aH
"}
(43,1,1) = {"
aH
aH
aH
aH
aH
aH
aH
aH
aH
aH
aH
aH
aH
aZ
aZ
aZ
aZ
aZ
aH
aH
aH
aH
aH
aH
aH
aH
aH
aH
aH
aH
"}
