//MAP CONVERTED BY dmm2tgm.py THIS HEADER COMMENT PREVENTS RECONVERSION, DO NOT REMOVE
"ab" = (
/obj/structure/overic_light/floor/hangar,
/turf/open/indestructible/overic/floor,
/area/hangar)
"ad" = (
/turf/open/indestructible/overic/energy,
/area/hangar)
"ai" = (
/turf/open/indestructible/overic/hangar{
	dir = 6
	},
/area/hangar)
"aj" = (
/obj/structure/overic_light/floor/hangar,
/turf/open/indestructible/overic,
/area/hangar)
"am" = (
/turf/open/indestructible/overic/hangar,
/area/hangar)
"ao" = (
/obj/machinery/door/overic/public{
	dir = 4
	},
/turf/open/indestructible/overic/floor,
/area/hangar)
"ar" = (
/obj/structure/table/overic,
/turf/open/indestructible/overic,
/area/hangar)
"at" = (
/obj/structure/overic_light/directional/north,
/obj/structure/table/overic,
/turf/open/indestructible/overic,
/area/hangar)
"au" = (
/turf/open/indestructible/overic/hangar{
	dir = 9
	},
/area/hangar)
"aw" = (
/obj/structure/netcable/end,
/turf/open/indestructible/overic/hangar{
	dir = 1
	},
/area/hangar)
"aA" = (
/obj/structure/netcable,
/turf/open/indestructible/overic/floor,
/area/hangar)
"aD" = (
/obj/machinery/door/airlock,
/obj/effect/landmark/outpost/elevator_machine,
/turf/open/indestructible/overic,
/area/hangar)
"aE" = (
/obj/structure/overic_light/directional/south,
/obj/structure/table/overic,
/turf/open/indestructible/overic,
/area/hangar)
"aG" = (
/obj/structure/netcable{
	dir = 1
	},
/turf/open/indestructible/overic,
/area/hangar)
"aH" = (
/obj/structure/netcable,
/turf/open/indestructible/overic,
/area/hangar)
"aI" = (
/obj/machinery/door/overic,
/turf/open/indestructible/overic/floor,
/area/hangar)
"aK" = (
/turf/open/indestructible/overic/hangar{
	dir = 5
	},
/area/hangar)
"aM" = (
/turf/open/indestructible/overic/hangar/middle,
/area/hangar)
"aN" = (
/turf/open/indestructible/overic/floor,
/area/hangar)
"aO" = (
/turf/open/indestructible/overic/hangar{
	dir = 4
	},
/area/hangar)
"aP" = (
/turf/open/indestructible/overic/hangar{
	dir = 1
	},
/area/hangar)
"aT" = (
/obj/structure/netcable{
	dir = 1
	},
/turf/open/indestructible/overic/floor,
/area/hangar)
"aU" = (
/turf/closed/indestructible/overic,
/area/hangar)
"aV" = (
/turf/template_noop,
/area/template_noop)
"aZ" = (
/obj/machinery/elevator_call_button{
	pixel_y = 25
	},
/obj/effect/landmark/outpost/elevator_machine,
/turf/open/indestructible/overic,
/area/hangar)
"ck" = (
/turf/open/indestructible/overic,
/area/hangar)
"eO" = (
/obj/machinery/door/overic{
	dir = 4
	},
/turf/open/indestructible/overic/floor,
/area/hangar)
"gJ" = (
/obj/structure/overic_light/directional/south,
/turf/open/indestructible/overic/floor,
/area/hangar)
"pO" = (
/obj/effect/landmark/outpost/hangar_dock,
/turf/open/indestructible/overic/hangar{
	dir = 10
	},
/area/hangar)
"wc" = (
/obj/effect/landmark/outpost/elevator,
/turf/open/indestructible/overic/energy,
/area/hangar)
"zm" = (
/obj/structure/overic_light/directional/east,
/turf/open/indestructible/overic,
/area/hangar)
"BI" = (
/obj/structure/overic_light/directional/west,
/turf/open/indestructible/overic,
/area/hangar)
"MF" = (
/obj/structure/overic_light/directional/north,
/turf/open/indestructible/overic/floor,
/area/hangar)
"MN" = (
/obj/structure/netcable/end{
	dir = 1
	},
/turf/open/indestructible/overic/hangar,
/area/hangar)
"NQ" = (
/obj/structure/overic_light/directional/east,
/turf/open/indestructible/overic/floor,
/area/hangar)
"Qi" = (
/turf/open/indestructible/overic/hangar{
	dir = 8
	},
/area/hangar)

(1,1,1) = {"
aU
aU
aU
aU
aU
aU
aU
aU
aU
aU
aU
aU
aU
aU
aU
aU
aU
aU
aU
aU
aU
aU
aU
aU
aU
aU
aU
aU
aU
aU
aU
aU
aU
aU
aU
aU
aU
aU
aU
aU
aU
aU
aU
aU
aU
aU
aU
aU
aU
aU
"}
(2,1,1) = {"
aU
aU
aU
aU
aU
aU
aU
aU
aU
aU
aU
aU
aU
aU
aU
aU
aU
aU
aU
aU
aU
aU
aU
aU
aU
aU
aU
aU
aU
aU
aU
aU
aU
aU
aU
aU
aU
aU
aU
aU
aU
aU
aU
aU
aU
aU
aU
aU
aU
aU
"}
(3,1,1) = {"
aU
aU
ck
ck
ck
ck
ck
ck
ck
ck
ck
ck
ck
ck
ck
ck
ck
ck
ck
ck
ck
ck
ck
ck
ck
ck
ck
ck
ck
ck
ck
ck
ck
ck
ck
ck
ck
ck
ck
ck
ck
ck
ck
ck
ck
ck
ck
ck
aU
aU
"}
(4,1,1) = {"
aU
aU
ck
aN
aN
aN
aN
aN
aN
aN
aN
aN
aN
aN
aN
aN
aN
aN
aN
aN
aN
aN
aN
aN
aN
aN
aN
aN
aN
aN
aN
aN
aN
aN
aN
aN
aN
aN
aN
aN
aN
aN
aN
aN
aN
aN
aN
ck
aU
aU
"}
(5,1,1) = {"
aU
aU
ck
aN
aN
aN
aN
aN
aN
aN
aN
aN
aN
aN
aN
aN
aN
aN
aN
aN
aN
aN
aN
aN
aN
aN
aN
aN
aN
aN
aN
aN
aN
aN
aN
aN
aN
aN
aN
aN
aN
aN
aN
aN
aN
aN
aN
ck
aU
aU
"}
(6,1,1) = {"
aU
aU
ck
aN
aN
au
Qi
Qi
Qi
Qi
Qi
Qi
Qi
Qi
Qi
Qi
Qi
Qi
Qi
Qi
Qi
Qi
Qi
Qi
Qi
Qi
Qi
Qi
Qi
Qi
Qi
Qi
Qi
Qi
Qi
Qi
Qi
Qi
Qi
Qi
Qi
Qi
Qi
Qi
pO
aN
aN
ck
aU
aU
"}
(7,1,1) = {"
aU
aU
ck
aN
aN
aP
aM
aM
aM
aM
aM
aM
aM
aM
aM
aM
aM
aM
aM
aM
aM
aM
aM
aM
aM
aM
aM
aM
aM
aM
aM
aM
aM
aM
aM
aM
aM
aM
aM
aM
aM
aM
aM
aM
am
aN
aN
ck
aU
aU
"}
(8,1,1) = {"
aU
aU
aH
aA
aA
aw
aM
aM
aM
aM
aM
aM
aM
aM
aM
aM
aM
aM
aM
aM
aM
aM
aM
aM
aM
aM
aM
aM
aM
aM
aM
aM
aM
aM
aM
aM
aM
aM
aM
aM
aM
aM
aM
aM
MN
aT
aT
aG
aU
aU
"}
(9,1,1) = {"
aU
aU
ck
aN
aN
aP
aM
aM
aM
aM
aM
aM
aM
aM
aM
aM
aM
aM
aM
aM
aM
aM
aM
aM
aM
aM
aM
aM
aM
aM
aM
aM
aM
aM
aM
aM
aM
aM
aM
aM
aM
aM
aM
aM
am
aN
aN
ck
aU
aU
"}
(10,1,1) = {"
aU
aU
ck
aN
ab
aP
aM
aM
aM
aM
aM
aM
aM
aM
aM
aM
aM
aM
aM
aM
aM
aM
aM
aM
aM
aM
aM
aM
aM
aM
aM
aM
aM
aM
aM
aM
aM
aM
aM
aM
aM
aM
aM
aM
am
ab
aN
ck
aU
aU
"}
(11,1,1) = {"
aU
aU
ck
aN
aN
aP
aM
aM
aM
aM
aM
aM
aM
aM
aM
aM
aM
aM
aM
aM
aM
aM
aM
aM
aM
aM
aM
aM
aM
aM
aM
aM
aM
aM
aM
aM
aM
aM
aM
aM
aM
aM
aM
aM
am
aN
aN
ck
aU
aU
"}
(12,1,1) = {"
aU
aU
ck
aN
aN
aP
aM
aM
aM
aM
aM
aM
aM
aM
aM
aM
aM
aM
aM
aM
aM
aM
aM
aM
aM
aM
aM
aM
aM
aM
aM
aM
aM
aM
aM
aM
aM
aM
aM
aM
aM
aM
aM
aM
am
aN
aN
ck
aU
aU
"}
(13,1,1) = {"
aU
aU
aH
aA
aA
aw
aM
aM
aM
aM
aM
aM
aM
aM
aM
aM
aM
aM
aM
aM
aM
aM
aM
aM
aM
aM
aM
aM
aM
aM
aM
aM
aM
aM
aM
aM
aM
aM
aM
aM
aM
aM
aM
aM
MN
aT
aT
aG
aU
aU
"}
(14,1,1) = {"
aU
aU
ck
aN
aN
aP
aM
aM
aM
aM
aM
aM
aM
aM
aM
aM
aM
aM
aM
aM
aM
aM
aM
aM
aM
aM
aM
aM
aM
aM
aM
aM
aM
aM
aM
aM
aM
aM
aM
aM
aM
aM
aM
aM
am
aN
aN
ck
aU
aU
"}
(15,1,1) = {"
aU
aU
ck
aN
aN
aP
aM
aM
aM
aM
aM
aM
aM
aM
aM
aM
aM
aM
aM
aM
aM
aM
aM
aM
aM
aM
aM
aM
aM
aM
aM
aM
aM
aM
aM
aM
aM
aM
aM
aM
aM
aM
aM
aM
am
aN
aN
ck
aU
aU
"}
(16,1,1) = {"
aU
aU
ck
aN
aN
aP
aM
aM
aM
aM
aM
aM
aM
aM
aM
aM
aM
aM
aM
aM
aM
aM
aM
aM
aM
aM
aM
aM
aM
aM
aM
aM
aM
aM
aM
aM
aM
aM
aM
aM
aM
aM
aM
aM
am
aN
aN
ck
aU
aU
"}
(17,1,1) = {"
aU
aU
ck
aN
aN
aP
aM
aM
aM
aM
aM
aM
aM
aM
aM
aM
aM
aM
aM
aM
aM
aM
aM
aM
aM
aM
aM
aM
aM
aM
aM
aM
aM
aM
aM
aM
aM
aM
aM
aM
aM
aM
aM
aM
am
aN
aN
ck
aU
aU
"}
(18,1,1) = {"
aU
aU
aH
aA
aT
aw
aM
aM
aM
aM
aM
aM
aM
aM
aM
aM
aM
aM
aM
aM
aM
aM
aM
aM
aM
aM
aM
aM
aM
aM
aM
aM
aM
aM
aM
aM
aM
aM
aM
aM
aM
aM
aM
aM
MN
aT
aT
aG
aU
aU
"}
(19,1,1) = {"
aU
aU
ck
aN
aN
aP
aM
aM
aM
aM
aM
aM
aM
aM
aM
aM
aM
aM
aM
aM
aM
aM
aM
aM
aM
aM
aM
aM
aM
aM
aM
aM
aM
aM
aM
aM
aM
aM
aM
aM
aM
aM
aM
aM
am
aN
aN
ck
aU
aU
"}
(20,1,1) = {"
aU
aU
ck
aN
ab
aP
aM
aM
aM
aM
aM
aM
aM
aM
aM
aM
aM
aM
aM
aM
aM
aM
aM
aM
aM
aM
aM
aM
aM
aM
aM
aM
aM
aM
aM
aM
aM
aM
aM
aM
aM
aM
aM
aM
am
ab
aN
ck
aU
aU
"}
(21,1,1) = {"
aU
aU
ck
aN
aN
aP
aM
aM
aM
aM
aM
aM
aM
aM
aM
aM
aM
aM
aM
aM
aM
aM
aM
aM
aM
aM
aM
aM
aM
aM
aM
aM
aM
aM
aM
aM
aM
aM
aM
aM
aM
aM
aM
aM
am
aN
aN
ck
aU
aU
"}
(22,1,1) = {"
aU
aU
ck
aN
aN
aP
aM
aM
aM
aM
aM
aM
aM
aM
aM
aM
aM
aM
aM
aM
aM
aM
aM
aM
aM
aM
aM
aM
aM
aM
aM
aM
aM
aM
aM
aM
aM
aM
aM
aM
aM
aM
aM
aM
am
aN
aN
ck
aU
aU
"}
(23,1,1) = {"
aU
aU
aH
aA
aA
aw
aM
aM
aM
aM
aM
aM
aM
aM
aM
aM
aM
aM
aM
aM
aM
aM
aM
aM
aM
aM
aM
aM
aM
aM
aM
aM
aM
aM
aM
aM
aM
aM
aM
aM
aM
aM
aM
aM
MN
aT
aT
aG
aU
aU
"}
(24,1,1) = {"
aU
aU
ck
aN
aN
aP
aM
aM
aM
aM
aM
aM
aM
aM
aM
aM
aM
aM
aM
aM
aM
aM
aM
aM
aM
aM
aM
aM
aM
aM
aM
aM
aM
aM
aM
aM
aM
aM
aM
aM
aM
aM
aM
aM
am
aN
aN
ck
aU
aU
"}
(25,1,1) = {"
aU
aU
ck
aN
aN
aP
aM
aM
aM
aM
aM
aM
aM
aM
aM
aM
aM
aM
aM
aM
aM
aM
aM
aM
aM
aM
aM
aM
aM
aM
aM
aM
aM
aM
aM
aM
aM
aM
aM
aM
aM
aM
aM
aM
am
aN
aN
ck
aU
aU
"}
(26,1,1) = {"
aU
aU
ck
aN
aN
aP
aM
aM
aM
aM
aM
aM
aM
aM
aM
aM
aM
aM
aM
aM
aM
aM
aM
aM
aM
aM
aM
aM
aM
aM
aM
aM
aM
aM
aM
aM
aM
aM
aM
aM
aM
aM
aM
aM
am
aN
aN
ck
aU
aU
"}
(27,1,1) = {"
aU
aU
ck
aN
aN
aP
aM
aM
aM
aM
aM
aM
aM
aM
aM
aM
aM
aM
aM
aM
aM
aM
aM
aM
aM
aM
aM
aM
aM
aM
aM
aM
aM
aM
aM
aM
aM
aM
aM
aM
aM
aM
aM
aM
am
aN
aN
ck
aU
aU
"}
(28,1,1) = {"
aU
aU
aH
aA
aA
aw
aM
aM
aM
aM
aM
aM
aM
aM
aM
aM
aM
aM
aM
aM
aM
aM
aM
aM
aM
aM
aM
aM
aM
aM
aM
aM
aM
aM
aM
aM
aM
aM
aM
aM
aM
aM
aM
aM
MN
aT
aT
aG
aU
aU
"}
(29,1,1) = {"
aU
aU
ck
aN
aN
aP
aM
aM
aM
aM
aM
aM
aM
aM
aM
aM
aM
aM
aM
aM
aM
aM
aM
aM
aM
aM
aM
aM
aM
aM
aM
aM
aM
aM
aM
aM
aM
aM
aM
aM
aM
aM
aM
aM
am
aN
aN
ck
aU
aU
"}
(30,1,1) = {"
aU
aU
ck
aN
ab
aP
aM
aM
aM
aM
aM
aM
aM
aM
aM
aM
aM
aM
aM
aM
aM
aM
aM
aM
aM
aM
aM
aM
aM
aM
aM
aM
aM
aM
aM
aM
aM
aM
aM
aM
aM
aM
aM
aM
am
ab
aN
ck
aU
aU
"}
(31,1,1) = {"
aU
aU
ck
aN
aN
aP
aM
aM
aM
aM
aM
aM
aM
aM
aM
aM
aM
aM
aM
aM
aM
aM
aM
aM
aM
aM
aM
aM
aM
aM
aM
aM
aM
aM
aM
aM
aM
aM
aM
aM
aM
aM
aM
aM
am
aN
aN
ck
aU
aU
"}
(32,1,1) = {"
aU
aU
ck
aN
aN
aP
aM
aM
aM
aM
aM
aM
aM
aM
aM
aM
aM
aM
aM
aM
aM
aM
aM
aM
aM
aM
aM
aM
aM
aM
aM
aM
aM
aM
aM
aM
aM
aM
aM
aM
aM
aM
aM
aM
am
aN
aN
ck
aU
aU
"}
(33,1,1) = {"
aU
aU
aH
aA
aA
aw
aM
aM
aM
aM
aM
aM
aM
aM
aM
aM
aM
aM
aM
aM
aM
aM
aM
aM
aM
aM
aM
aM
aM
aM
aM
aM
aM
aM
aM
aM
aM
aM
aM
aM
aM
aM
aM
aM
MN
aT
aT
aG
aU
aU
"}
(34,1,1) = {"
aU
aU
ck
aN
aN
aP
aM
aM
aM
aM
aM
aM
aM
aM
aM
aM
aM
aM
aM
aM
aM
aM
aM
aM
aM
aM
aM
aM
aM
aM
aM
aM
aM
aM
aM
aM
aM
aM
aM
aM
aM
aM
aM
aM
am
aN
aN
ck
aU
aU
"}
(35,1,1) = {"
aU
aU
ck
aN
aN
aP
aM
aM
aM
aM
aM
aM
aM
aM
aM
aM
aM
aM
aM
aM
aM
aM
aM
aM
aM
aM
aM
aM
aM
aM
aM
aM
aM
aM
aM
aM
aM
aM
aM
aM
aM
aM
aM
aM
am
aN
aN
ck
aU
aU
"}
(36,1,1) = {"
aU
aU
ck
aN
aN
aP
aM
aM
aM
aM
aM
aM
aM
aM
aM
aM
aM
aM
aM
aM
aM
aM
aM
aM
aM
aM
aM
aM
aM
aM
aM
aM
aM
aM
aM
aM
aM
aM
aM
aM
aM
aM
aM
aM
am
aN
aN
ck
aU
aU
"}
(37,1,1) = {"
aU
aU
ck
aN
aN
aP
aM
aM
aM
aM
aM
aM
aM
aM
aM
aM
aM
aM
aM
aM
aM
aM
aM
aM
aM
aM
aM
aM
aM
aM
aM
aM
aM
aM
aM
aM
aM
aM
aM
aM
aM
aM
aM
aM
am
aN
aN
ck
aU
aU
"}
(38,1,1) = {"
aU
aU
aH
aA
aA
aw
aM
aM
aM
aM
aM
aM
aM
aM
aM
aM
aM
aM
aM
aM
aM
aM
aM
aM
aM
aM
aM
aM
aM
aM
aM
aM
aM
aM
aM
aM
aM
aM
aM
aM
aM
aM
aM
aM
MN
aT
aT
aG
aU
aU
"}
(39,1,1) = {"
aU
aU
ck
aN
aN
aP
aM
aM
aM
aM
aM
aM
aM
aM
aM
aM
aM
aM
aM
aM
aM
aM
aM
aM
aM
aM
aM
aM
aM
aM
aM
aM
aM
aM
aM
aM
aM
aM
aM
aM
aM
aM
aM
aM
am
aN
aN
ck
aU
aU
"}
(40,1,1) = {"
aU
aU
ck
aN
ab
aP
aM
aM
aM
aM
aM
aM
aM
aM
aM
aM
aM
aM
aM
aM
aM
aM
aM
aM
aM
aM
aM
aM
aM
aM
aM
aM
aM
aM
aM
aM
aM
aM
aM
aM
aM
aM
aM
aM
am
ab
aN
ck
aU
aU
"}
(41,1,1) = {"
aU
aU
ck
aN
aN
aP
aM
aM
aM
aM
aM
aM
aM
aM
aM
aM
aM
aM
aM
aM
aM
aM
aM
aM
aM
aM
aM
aM
aM
aM
aM
aM
aM
aM
aM
aM
aM
aM
aM
aM
aM
aM
aM
aM
am
aN
aN
ck
aU
aU
"}
(42,1,1) = {"
aU
aU
ck
aN
aN
aP
aM
aM
aM
aM
aM
aM
aM
aM
aM
aM
aM
aM
aM
aM
aM
aM
aM
aM
aM
aM
aM
aM
aM
aM
aM
aM
aM
aM
aM
aM
aM
aM
aM
aM
aM
aM
aM
aM
am
aN
aN
ck
aU
aU
"}
(43,1,1) = {"
aU
aU
aH
aA
aA
aw
aM
aM
aM
aM
aM
aM
aM
aM
aM
aM
aM
aM
aM
aM
aM
aM
aM
aM
aM
aM
aM
aM
aM
aM
aM
aM
aM
aM
aM
aM
aM
aM
aM
aM
aM
aM
aM
aM
MN
aT
aT
aG
aU
aU
"}
(44,1,1) = {"
aU
aU
ck
aN
aN
aP
aM
aM
aM
aM
aM
aM
aM
aM
aM
aM
aM
aM
aM
aM
aM
aM
aM
aM
aM
aM
aM
aM
aM
aM
aM
aM
aM
aM
aM
aM
aM
aM
aM
aM
aM
aM
aM
aM
am
aN
aN
ck
aU
aU
"}
(45,1,1) = {"
aU
aU
ck
aN
aN
aP
aM
aM
aM
aM
aM
aM
aM
aM
aM
aM
aM
aM
aM
aM
aM
aM
aM
aM
aM
aM
aM
aM
aM
aM
aM
aM
aM
aM
aM
aM
aM
aM
aM
aM
aM
aM
aM
aM
am
aN
aN
ck
aU
aU
"}
(46,1,1) = {"
aU
aU
ck
aN
aN
aP
aM
aM
aM
aM
aM
aM
aM
aM
aM
aM
aM
aM
aM
aM
aM
aM
aM
aM
aM
aM
aM
aM
aM
aM
aM
aM
aM
aM
aM
aM
aM
aM
aM
aM
aM
aM
aM
aM
am
aN
aN
ck
aU
aU
"}
(47,1,1) = {"
aU
aU
ck
aN
aN
aP
aM
aM
aM
aM
aM
aM
aM
aM
aM
aM
aM
aM
aM
aM
aM
aM
aM
aM
aM
aM
aM
aM
aM
aM
aM
aM
aM
aM
aM
aM
aM
aM
aM
aM
aM
aM
aM
aM
am
aN
aN
ck
aU
aU
"}
(48,1,1) = {"
aU
aU
aH
aA
aA
aw
aM
aM
aM
aM
aM
aM
aM
aM
aM
aM
aM
aM
aM
aM
aM
aM
aM
aM
aM
aM
aM
aM
aM
aM
aM
aM
aM
aM
aM
aM
aM
aM
aM
aM
aM
aM
aM
aM
MN
aT
aT
aG
aU
aU
"}
(49,1,1) = {"
aU
aU
ck
aN
aN
aP
aM
aM
aM
aM
aM
aM
aM
aM
aM
aM
aM
aM
aM
aM
aM
aM
aM
aM
aM
aM
aM
aM
aM
aM
aM
aM
aM
aM
aM
aM
aM
aM
aM
aM
aM
aM
aM
aM
am
aN
aN
ck
aU
aU
"}
(50,1,1) = {"
aU
aU
ck
aN
ab
aP
aM
aM
aM
aM
aM
aM
aM
aM
aM
aM
aM
aM
aM
aM
aM
aM
aM
aM
aM
aM
aM
aM
aM
aM
aM
aM
aM
aM
aM
aM
aM
aM
aM
aM
aM
aM
aM
aM
am
ab
aN
ck
aU
aU
"}
(51,1,1) = {"
aU
aU
ck
aN
aN
aP
aM
aM
aM
aM
aM
aM
aM
aM
aM
aM
aM
aM
aM
aM
aM
aM
aM
aM
aM
aM
aM
aM
aM
aM
aM
aM
aM
aM
aM
aM
aM
aM
aM
aM
aM
aM
aM
aM
am
aN
aN
ck
aU
aU
"}
(52,1,1) = {"
aU
aU
ck
aN
aN
aP
aM
aM
aM
aM
aM
aM
aM
aM
aM
aM
aM
aM
aM
aM
aM
aM
aM
aM
aM
aM
aM
aM
aM
aM
aM
aM
aM
aM
aM
aM
aM
aM
aM
aM
aM
aM
aM
aM
am
aN
aN
ck
aU
aU
"}
(53,1,1) = {"
aU
aU
aH
aA
aA
aw
aM
aM
aM
aM
aM
aM
aM
aM
aM
aM
aM
aM
aM
aM
aM
aM
aM
aM
aM
aM
aM
aM
aM
aM
aM
aM
aM
aM
aM
aM
aM
aM
aM
aM
aM
aM
aM
aM
MN
aT
aT
aG
aU
aU
"}
(54,1,1) = {"
aU
aU
ck
aN
aN
aP
aM
aM
aM
aM
aM
aM
aM
aM
aM
aM
aM
aM
aM
aM
aM
aM
aM
aM
aM
aM
aM
aM
aM
aM
aM
aM
aM
aM
aM
aM
aM
aM
aM
aM
aM
aM
aM
aM
am
aN
aN
ck
aU
aU
"}
(55,1,1) = {"
aU
aU
ck
aN
aN
aP
aM
aM
aM
aM
aM
aM
aM
aM
aM
aM
aM
aM
aM
aM
aM
aM
aM
aM
aM
aM
aM
aM
aM
aM
aM
aM
aM
aM
aM
aM
aM
aM
aM
aM
aM
aM
aM
aM
am
aN
aN
ck
aU
aU
"}
(56,1,1) = {"
aU
aU
ck
aN
aN
aP
aM
aM
aM
aM
aM
aM
aM
aM
aM
aM
aM
aM
aM
aM
aM
aM
aM
aM
aM
aM
aM
aM
aM
aM
aM
aM
aM
aM
aM
aM
aM
aM
aM
aM
aM
aM
aM
aM
am
aN
aN
ck
aU
aU
"}
(57,1,1) = {"
aU
aU
ck
aN
aN
aP
aM
aM
aM
aM
aM
aM
aM
aM
aM
aM
aM
aM
aM
aM
aM
aM
aM
aM
aM
aM
aM
aM
aM
aM
aM
aM
aM
aM
aM
aM
aM
aM
aM
aM
aM
aM
aM
aM
am
aN
aN
ck
aU
aU
"}
(58,1,1) = {"
aU
aU
aH
aA
aA
aw
aM
aM
aM
aM
aM
aM
aM
aM
aM
aM
aM
aM
aM
aM
aM
aM
aM
aM
aM
aM
aM
aM
aM
aM
aM
aM
aM
aM
aM
aM
aM
aM
aM
aM
aM
aM
aM
aM
MN
aT
aT
aG
aU
aU
"}
(59,1,1) = {"
aU
aU
ck
aN
aN
aP
aM
aM
aM
aM
aM
aM
aM
aM
aM
aM
aM
aM
aM
aM
aM
aM
aM
aM
aM
aM
aM
aM
aM
aM
aM
aM
aM
aM
aM
aM
aM
aM
aM
aM
aM
aM
aM
aM
am
aN
aN
ck
aU
aU
"}
(60,1,1) = {"
aU
aU
ck
aN
ab
aP
aM
aM
aM
aM
aM
aM
aM
aM
aM
aM
aM
aM
aM
aM
aM
aM
aM
aM
aM
aM
aM
aM
aM
aM
aM
aM
aM
aM
aM
aM
aM
aM
aM
aM
aM
aM
aM
aM
am
ab
aN
ck
aU
aU
"}
(61,1,1) = {"
aU
aU
ck
aN
aN
aK
aO
aO
aO
aO
aO
aO
aO
aO
aO
aO
aO
aO
aO
aO
aO
aO
aO
aO
aO
aO
aO
aO
aO
aO
aO
aO
aO
aO
aO
aO
aO
aO
aO
aO
aO
aO
aO
aO
ai
aN
aN
ck
aU
aU
"}
(62,1,1) = {"
aU
aU
ck
aN
aN
aN
aN
aN
aN
aN
aN
aN
aN
aN
aN
aN
aN
aN
aN
aN
aN
aN
aN
aN
aN
aN
aN
aN
aN
aN
aN
aN
aN
aN
aN
aN
aN
aN
aN
aN
aN
aN
aN
aN
aN
aN
aN
ck
aU
aU
"}
(63,1,1) = {"
aU
aU
ck
aN
aN
aN
aN
aN
aN
aN
aN
aN
aN
aN
aN
aN
aN
aN
aN
aN
aN
aN
aN
aN
aN
aN
aN
aN
aN
aN
aN
aN
aN
aN
aN
aN
aN
aN
aN
aN
aN
aN
aN
aN
aN
aN
aN
ck
aU
aU
"}
(64,1,1) = {"
aU
aU
ck
ck
ck
ck
ck
ck
aj
ck
ck
ck
ck
ck
ck
aj
ck
ck
ck
ck
ck
ck
ck
ck
aj
aj
ck
ck
ck
ck
ck
ck
ck
ck
aj
ck
ck
ck
ck
ck
ck
aj
ck
ck
ck
ck
ck
ck
aU
aU
"}
(65,1,1) = {"
aU
aU
aU
aU
aU
aU
aU
aU
aU
aU
aU
aU
aU
aU
aU
aU
aU
aU
aU
aU
aU
aU
aU
aU
ao
aU
ao
aU
aU
aU
aU
aU
aU
aU
aU
aU
aU
aU
aU
aU
aU
aU
aU
aU
aU
aU
aU
aU
aU
aU
"}
(66,1,1) = {"
aU
aU
aU
aU
aU
aU
aU
aU
aU
aU
aU
aU
aU
aU
aU
aU
aU
aU
aU
aU
ar
ar
ar
ck
aN
aN
aN
ck
ar
ar
ar
aU
aU
aU
aU
aU
aU
aU
aU
aU
aU
aU
aU
aU
aU
aU
aU
aU
aU
aU
"}
(67,1,1) = {"
aV
aV
aV
aV
aV
aV
aV
aV
aV
aV
aV
aV
aV
aV
aV
aV
aV
aV
aU
aU
at
aN
aN
aN
aN
aN
aN
aN
aN
aN
aE
aU
aU
aV
aV
aV
aV
aV
aV
aV
aV
aV
aV
aV
aV
aV
aV
aV
aV
aV
"}
(68,1,1) = {"
aV
aV
aV
aV
aV
aV
aV
aV
aV
aV
aV
aV
aV
aV
aV
aV
aV
aV
aU
aU
ar
aN
ck
ck
ck
zm
ck
ck
ck
aN
ar
aU
aU
aV
aV
aV
aV
aV
aV
aV
aV
aV
aV
aV
aV
aV
aV
aV
aV
aV
"}
(69,1,1) = {"
aV
aV
aV
aV
aV
aV
aV
aV
aV
aV
aV
aV
aV
aV
aV
aV
aV
aU
aU
aU
ck
aN
ck
aU
aU
aU
aU
aU
aZ
aN
ck
aU
aU
aU
aV
aV
aV
aV
aV
aV
aV
aV
aV
aV
aV
aV
aV
aV
aV
aV
"}
(70,1,1) = {"
aV
aV
aV
aV
aV
aV
aV
aV
aV
aV
aV
aV
aV
aV
aV
aV
aV
aU
aN
aI
aN
aN
aN
aU
ad
ad
wc
aD
aN
aN
aN
aI
aN
aU
aV
aV
aV
aV
aV
aV
aV
aV
aV
aV
aV
aV
aV
aV
aV
aV
"}
(71,1,1) = {"
aV
aV
aV
aV
aV
aV
aV
aV
aV
aV
aV
aV
aV
aV
aV
aV
aV
aU
MF
aU
aN
aN
gJ
aU
ad
ad
ad
aD
aN
aN
aN
aU
gJ
aU
aV
aV
aV
aV
aV
aV
aV
aV
aV
aV
aV
aV
aV
aV
aV
aV
"}
(72,1,1) = {"
aV
aV
aV
aV
aV
aV
aV
aV
aV
aV
aV
aV
aV
aV
aV
aV
aV
aU
aN
aI
aN
aN
aN
aU
ad
ad
ad
aD
aN
aN
aN
aI
aN
aU
aV
aV
aV
aV
aV
aV
aV
aV
aV
aV
aV
aV
aV
aV
aV
aV
"}
(73,1,1) = {"
aV
aV
aV
aV
aV
aV
aV
aV
aV
aV
aV
aV
aV
aV
aV
aV
aV
aU
aU
aU
ck
aN
ck
aU
aU
aU
aU
aU
ck
aN
ck
aU
aU
aU
aV
aV
aV
aV
aV
aV
aV
aV
aV
aV
aV
aV
aV
aV
aV
aV
"}
(74,1,1) = {"
aV
aV
aV
aV
aV
aV
aV
aV
aV
aV
aV
aV
aV
aV
aV
aV
aV
aV
aU
aU
ar
aN
ck
ck
ck
BI
ck
ck
ck
aN
ar
aU
aU
aV
aV
aV
aV
aV
aV
aV
aV
aV
aV
aV
aV
aV
aV
aV
aV
aV
"}
(75,1,1) = {"
aV
aV
aV
aV
aV
aV
aV
aV
aV
aV
aV
aV
aV
aV
aV
aV
aV
aV
aU
aU
at
aN
aN
aN
aN
aN
aN
aN
aN
aN
aE
aU
aU
aV
aV
aV
aV
aV
aV
aV
aV
aV
aV
aV
aV
aV
aV
aV
aV
aV
"}
(76,1,1) = {"
aV
aV
aV
aV
aV
aV
aV
aV
aV
aV
aV
aV
aV
aV
aV
aV
aV
aV
aU
aU
ar
ar
ar
ck
aN
aN
aN
ck
ar
ar
ar
aU
aU
aV
aV
aV
aV
aV
aV
aV
aV
aV
aV
aV
aV
aV
aV
aV
aV
aV
"}
(77,1,1) = {"
aV
aV
aV
aV
aV
aV
aV
aV
aV
aV
aV
aV
aV
aV
aV
aV
aV
aV
aU
aU
aU
aU
aU
aU
eO
aU
eO
aU
aU
aU
aU
aU
aU
aV
aV
aV
aV
aV
aV
aV
aV
aV
aV
aV
aV
aV
aV
aV
aV
aV
"}
(78,1,1) = {"
aV
aV
aV
aV
aV
aV
aV
aV
aV
aV
aV
aV
aV
aV
aV
aV
aV
aV
aU
aU
aU
aU
aU
aU
aN
NQ
aN
aU
aU
aU
aU
aU
aU
aV
aV
aV
aV
aV
aV
aV
aV
aV
aV
aV
aV
aV
aV
aV
aV
aV
"}
(79,1,1) = {"
aV
aV
aV
aV
aV
aV
aV
aV
aV
aV
aV
aV
aV
aV
aV
aV
aV
aV
aV
aV
aV
aV
aV
aU
aU
aU
aU
aU
aV
aV
aV
aV
aV
aV
aV
aV
aV
aV
aV
aV
aV
aV
aV
aV
aV
aV
aV
aV
aV
aV
"}
