//MAP CONVERTED BY dmm2tgm.py THIS HEADER COMMENT PREVENTS RECONVERSION, DO NOT REMOVE
"ab" = (
/obj/structure/netcable,
/turf/open/indestructible/overic,
/area/hangar)
"ae" = (
/obj/machinery/door/overic,
/turf/open/indestructible/overic/floor,
/area/hangar)
"af" = (
/obj/structure/netcable/end{
	dir = 1
	},
/turf/open/indestructible/overic/hangar,
/area/hangar)
"ai" = (
/turf/open/indestructible/overic/hangar{
	dir = 1
	},
/area/hangar)
"aj" = (
/turf/open/indestructible/overic,
/area/hangar)
"al" = (
/obj/structure/overic_light/directional/south,
/turf/open/indestructible/overic/floor,
/area/hangar)
"ap" = (
/obj/structure/table/overic,
/turf/open/indestructible/overic,
/area/hangar)
"as" = (
/turf/open/indestructible/overic/floor,
/area/hangar)
"av" = (
/obj/structure/netcable,
/turf/open/indestructible/overic/floor,
/area/hangar)
"aw" = (
/obj/structure/overic_light/directional/west,
/turf/open/indestructible/overic,
/area/hangar)
"aA" = (
/obj/structure/overic_light/floor/hangar,
/turf/open/indestructible/overic/floor,
/area/hangar)
"aD" = (
/turf/open/indestructible/overic/hangar,
/area/hangar)
"aF" = (
/obj/effect/landmark/outpost/hangar_dock,
/turf/open/indestructible/overic/hangar{
	dir = 10
	},
/area/hangar)
"aG" = (
/turf/open/indestructible/overic/hangar/middle,
/area/hangar)
"aH" = (
/obj/machinery/door/airlock,
/obj/effect/landmark/outpost/elevator_machine,
/turf/open/indestructible/overic,
/area/hangar)
"aL" = (
/obj/structure/netcable/end,
/turf/open/indestructible/overic/hangar{
	dir = 1
	},
/area/hangar)
"aM" = (
/turf/open/indestructible/overic/hangar{
	dir = 5
	},
/area/hangar)
"aO" = (
/turf/closed/indestructible/overic,
/area/hangar)
"aP" = (
/turf/template_noop,
/area/template_noop)
"aR" = (
/obj/effect/landmark/outpost/elevator,
/turf/open/indestructible/overic/energy,
/area/hangar)
"aT" = (
/obj/structure/overic_light/directional/south,
/obj/structure/table/overic,
/turf/open/indestructible/overic,
/area/hangar)
"aU" = (
/turf/open/indestructible/overic/hangar{
	dir = 4
	},
/area/hangar)
"aX" = (
/turf/open/indestructible/overic/hangar{
	dir = 8
	},
/area/hangar)
"aY" = (
/obj/machinery/door/overic/public{
	dir = 4
	},
/turf/open/indestructible/overic/floor,
/area/hangar)
"mO" = (
/turf/open/indestructible/overic/hangar{
	dir = 6
	},
/area/hangar)
"mY" = (
/obj/machinery/door/overic{
	dir = 4
	},
/turf/open/indestructible/overic/floor,
/area/hangar)
"wK" = (
/obj/structure/overic_light/directional/north,
/turf/open/indestructible/overic/floor,
/area/hangar)
"CT" = (
/obj/machinery/elevator_call_button{
	pixel_y = 25
	},
/obj/effect/landmark/outpost/elevator_machine,
/turf/open/indestructible/overic,
/area/hangar)
"Er" = (
/obj/structure/overic_light/directional/east,
/turf/open/indestructible/overic/floor,
/area/hangar)
"JT" = (
/turf/open/indestructible/overic/energy,
/area/hangar)
"OP" = (
/obj/structure/overic_light/floor/hangar,
/turf/open/indestructible/overic,
/area/hangar)
"Tl" = (
/obj/structure/overic_light/directional/north,
/obj/structure/table/overic,
/turf/open/indestructible/overic,
/area/hangar)
"Tu" = (
/turf/open/indestructible/overic/hangar{
	dir = 9
	},
/area/hangar)
"TX" = (
/obj/structure/overic_light/directional/east,
/turf/open/indestructible/overic,
/area/hangar)

(1,1,1) = {"
aO
aO
aO
aO
aO
aO
aO
aO
aO
aO
aO
aO
aO
aO
aO
aO
aO
aO
aO
aO
aO
aO
aO
aO
aO
aO
aO
aO
aO
aO
"}
(2,1,1) = {"
aO
aO
aO
aO
aO
aO
aO
aO
aO
aO
aO
aO
aO
aO
aO
aO
aO
aO
aO
aO
aO
aO
aO
aO
aO
aO
aO
aO
aO
aO
"}
(3,1,1) = {"
aO
aO
aj
aj
aj
aj
aj
aj
aj
aj
aj
aj
aj
aj
aj
aj
aj
aj
aj
aj
aj
aj
aj
aj
aj
aj
aj
aj
aO
aO
"}
(4,1,1) = {"
aO
aO
aj
as
as
as
as
as
as
as
as
as
as
as
as
as
as
as
as
as
as
as
as
as
as
as
as
aj
aO
aO
"}
(5,1,1) = {"
aO
aO
aj
as
as
as
as
as
as
as
as
as
as
as
as
as
as
as
as
as
as
as
as
as
as
as
as
aj
aO
aO
"}
(6,1,1) = {"
aO
aO
aj
as
as
Tu
aX
aX
aX
aX
aX
aX
aX
aX
aX
aX
aX
aX
aX
aX
aX
aX
aX
aX
aF
as
as
aj
aO
aO
"}
(7,1,1) = {"
aO
aO
ab
av
av
aL
aG
aG
aG
aG
aG
aG
aG
aG
aG
aG
aG
aG
aG
aG
aG
aG
aG
aG
af
av
av
ab
aO
aO
"}
(8,1,1) = {"
aO
aO
aj
as
as
ai
aG
aG
aG
aG
aG
aG
aG
aG
aG
aG
aG
aG
aG
aG
aG
aG
aG
aG
aD
as
as
aj
aO
aO
"}
(9,1,1) = {"
aO
aO
aj
as
as
ai
aG
aG
aG
aG
aG
aG
aG
aG
aG
aG
aG
aG
aG
aG
aG
aG
aG
aG
aD
as
as
aj
aO
aO
"}
(10,1,1) = {"
aO
aO
aj
as
aA
ai
aG
aG
aG
aG
aG
aG
aG
aG
aG
aG
aG
aG
aG
aG
aG
aG
aG
aG
aD
aA
as
aj
aO
aO
"}
(11,1,1) = {"
aO
aO
aj
as
as
ai
aG
aG
aG
aG
aG
aG
aG
aG
aG
aG
aG
aG
aG
aG
aG
aG
aG
aG
aD
as
as
aj
aO
aO
"}
(12,1,1) = {"
aO
aO
aj
as
as
ai
aG
aG
aG
aG
aG
aG
aG
aG
aG
aG
aG
aG
aG
aG
aG
aG
aG
aG
aD
as
as
aj
aO
aO
"}
(13,1,1) = {"
aO
aO
ab
av
av
aL
aG
aG
aG
aG
aG
aG
aG
aG
aG
aG
aG
aG
aG
aG
aG
aG
aG
aG
af
av
av
ab
aO
aO
"}
(14,1,1) = {"
aO
aO
aj
as
as
ai
aG
aG
aG
aG
aG
aG
aG
aG
aG
aG
aG
aG
aG
aG
aG
aG
aG
aG
aD
as
as
aj
aO
aO
"}
(15,1,1) = {"
aO
aO
aj
as
as
ai
aG
aG
aG
aG
aG
aG
aG
aG
aG
aG
aG
aG
aG
aG
aG
aG
aG
aG
aD
as
as
aj
aO
aO
"}
(16,1,1) = {"
aO
aO
aj
as
as
ai
aG
aG
aG
aG
aG
aG
aG
aG
aG
aG
aG
aG
aG
aG
aG
aG
aG
aG
aD
as
as
aj
aO
aO
"}
(17,1,1) = {"
aO
aO
ab
av
av
aL
aG
aG
aG
aG
aG
aG
aG
aG
aG
aG
aG
aG
aG
aG
aG
aG
aG
aG
af
av
av
ab
aO
aO
"}
(18,1,1) = {"
aO
aO
aj
as
as
ai
aG
aG
aG
aG
aG
aG
aG
aG
aG
aG
aG
aG
aG
aG
aG
aG
aG
aG
aD
as
as
aj
aO
aO
"}
(19,1,1) = {"
aO
aO
aj
as
as
ai
aG
aG
aG
aG
aG
aG
aG
aG
aG
aG
aG
aG
aG
aG
aG
aG
aG
aG
aD
as
as
aj
aO
aO
"}
(20,1,1) = {"
aO
aO
aj
as
aA
ai
aG
aG
aG
aG
aG
aG
aG
aG
aG
aG
aG
aG
aG
aG
aG
aG
aG
aG
aD
aA
as
aj
aO
aO
"}
(21,1,1) = {"
aO
aO
aj
as
as
ai
aG
aG
aG
aG
aG
aG
aG
aG
aG
aG
aG
aG
aG
aG
aG
aG
aG
aG
aD
as
as
aj
aO
aO
"}
(22,1,1) = {"
aO
aO
aj
as
as
ai
aG
aG
aG
aG
aG
aG
aG
aG
aG
aG
aG
aG
aG
aG
aG
aG
aG
aG
aD
as
as
aj
aO
aO
"}
(23,1,1) = {"
aO
aO
ab
av
av
aL
aG
aG
aG
aG
aG
aG
aG
aG
aG
aG
aG
aG
aG
aG
aG
aG
aG
aG
af
av
av
ab
aO
aO
"}
(24,1,1) = {"
aO
aO
aj
as
as
ai
aG
aG
aG
aG
aG
aG
aG
aG
aG
aG
aG
aG
aG
aG
aG
aG
aG
aG
aD
as
as
aj
aO
aO
"}
(25,1,1) = {"
aO
aO
aj
as
as
ai
aG
aG
aG
aG
aG
aG
aG
aG
aG
aG
aG
aG
aG
aG
aG
aG
aG
aG
aD
as
as
aj
aO
aO
"}
(26,1,1) = {"
aO
aO
aj
as
as
ai
aG
aG
aG
aG
aG
aG
aG
aG
aG
aG
aG
aG
aG
aG
aG
aG
aG
aG
aD
as
as
aj
aO
aO
"}
(27,1,1) = {"
aO
aO
ab
av
av
aL
aG
aG
aG
aG
aG
aG
aG
aG
aG
aG
aG
aG
aG
aG
aG
aG
aG
aG
af
av
av
ab
aO
aO
"}
(28,1,1) = {"
aO
aO
aj
as
as
ai
aG
aG
aG
aG
aG
aG
aG
aG
aG
aG
aG
aG
aG
aG
aG
aG
aG
aG
aD
as
as
aj
aO
aO
"}
(29,1,1) = {"
aO
aO
aj
as
as
ai
aG
aG
aG
aG
aG
aG
aG
aG
aG
aG
aG
aG
aG
aG
aG
aG
aG
aG
aD
as
as
aj
aO
aO
"}
(30,1,1) = {"
aO
aO
aj
as
aA
ai
aG
aG
aG
aG
aG
aG
aG
aG
aG
aG
aG
aG
aG
aG
aG
aG
aG
aG
aD
aA
as
aj
aO
aO
"}
(31,1,1) = {"
aO
aO
aj
as
as
ai
aG
aG
aG
aG
aG
aG
aG
aG
aG
aG
aG
aG
aG
aG
aG
aG
aG
aG
aD
as
as
aj
aO
aO
"}
(32,1,1) = {"
aO
aO
aj
as
as
ai
aG
aG
aG
aG
aG
aG
aG
aG
aG
aG
aG
aG
aG
aG
aG
aG
aG
aG
aD
as
as
aj
aO
aO
"}
(33,1,1) = {"
aO
aO
ab
av
av
aL
aG
aG
aG
aG
aG
aG
aG
aG
aG
aG
aG
aG
aG
aG
aG
aG
aG
aG
af
av
av
ab
aO
aO
"}
(34,1,1) = {"
aO
aO
aj
as
as
ai
aG
aG
aG
aG
aG
aG
aG
aG
aG
aG
aG
aG
aG
aG
aG
aG
aG
aG
aD
as
as
aj
aO
aO
"}
(35,1,1) = {"
aO
aO
aj
as
as
ai
aG
aG
aG
aG
aG
aG
aG
aG
aG
aG
aG
aG
aG
aG
aG
aG
aG
aG
aD
as
as
aj
aO
aO
"}
(36,1,1) = {"
aO
aO
aj
as
as
ai
aG
aG
aG
aG
aG
aG
aG
aG
aG
aG
aG
aG
aG
aG
aG
aG
aG
aG
aD
as
as
aj
aO
aO
"}
(37,1,1) = {"
aO
aO
ab
av
av
aL
aG
aG
aG
aG
aG
aG
aG
aG
aG
aG
aG
aG
aG
aG
aG
aG
aG
aG
af
av
av
ab
aO
aO
"}
(38,1,1) = {"
aO
aO
aj
as
as
ai
aG
aG
aG
aG
aG
aG
aG
aG
aG
aG
aG
aG
aG
aG
aG
aG
aG
aG
aD
as
as
aj
aO
aO
"}
(39,1,1) = {"
aO
aO
aj
as
as
ai
aG
aG
aG
aG
aG
aG
aG
aG
aG
aG
aG
aG
aG
aG
aG
aG
aG
aG
aD
as
as
aj
aO
aO
"}
(40,1,1) = {"
aO
aO
aj
as
aA
ai
aG
aG
aG
aG
aG
aG
aG
aG
aG
aG
aG
aG
aG
aG
aG
aG
aG
aG
aD
aA
as
aj
aO
aO
"}
(41,1,1) = {"
aO
aO
aj
as
as
ai
aG
aG
aG
aG
aG
aG
aG
aG
aG
aG
aG
aG
aG
aG
aG
aG
aG
aG
aD
as
as
aj
aO
aO
"}
(42,1,1) = {"
aO
aO
aj
as
as
ai
aG
aG
aG
aG
aG
aG
aG
aG
aG
aG
aG
aG
aG
aG
aG
aG
aG
aG
aD
as
as
aj
aO
aO
"}
(43,1,1) = {"
aO
aO
ab
av
av
aL
aG
aG
aG
aG
aG
aG
aG
aG
aG
aG
aG
aG
aG
aG
aG
aG
aG
aG
af
av
av
ab
aO
aO
"}
(44,1,1) = {"
aO
aO
aj
as
as
ai
aG
aG
aG
aG
aG
aG
aG
aG
aG
aG
aG
aG
aG
aG
aG
aG
aG
aG
aD
as
as
aj
aO
aO
"}
(45,1,1) = {"
aO
aO
aj
as
as
aM
aU
aU
aU
aU
aU
aU
aU
aU
aU
aU
aU
aU
aU
aU
aU
aU
aU
aU
mO
as
as
aj
aO
aO
"}
(46,1,1) = {"
aO
aO
aj
as
as
as
as
as
as
as
as
as
as
as
as
as
as
as
as
as
as
as
as
as
as
as
as
aj
aO
aO
"}
(47,1,1) = {"
aO
aO
aj
as
as
as
as
as
as
as
as
as
as
as
as
as
as
as
as
as
as
as
as
as
as
as
as
aj
aO
aO
"}
(48,1,1) = {"
aO
aO
aj
aj
aj
aj
OP
aj
aj
aj
aj
aj
aj
aj
aj
aj
aj
aj
aj
aj
aj
aj
aj
OP
aj
aj
aj
aj
aO
aO
"}
(49,1,1) = {"
aO
aO
aO
aO
aO
aO
aO
aO
aO
aO
aO
aO
aO
aO
aY
aO
aY
aO
aO
aO
aO
aO
aO
aO
aO
aO
aO
aO
aO
aO
"}
(50,1,1) = {"
aO
aO
aO
aO
aO
aO
aO
aO
aO
aO
ap
ap
ap
aj
as
as
as
aj
ap
ap
ap
aO
aO
aO
aO
aO
aO
aO
aO
aO
"}
(51,1,1) = {"
aP
aP
aP
aP
aP
aP
aP
aP
aO
aO
Tl
as
as
as
as
as
as
as
as
as
aT
aO
aO
aP
aP
aP
aP
aP
aP
aP
"}
(52,1,1) = {"
aP
aP
aP
aP
aP
aP
aP
aP
aO
aO
ap
as
aj
aj
aj
TX
aj
aj
aj
as
ap
aO
aO
aP
aP
aP
aP
aP
aP
aP
"}
(53,1,1) = {"
aP
aP
aP
aP
aP
aP
aP
aO
aO
aO
aj
as
aj
aO
aO
aO
aO
aO
CT
as
aj
aO
aO
aO
aP
aP
aP
aP
aP
aP
"}
(54,1,1) = {"
aP
aP
aP
aP
aP
aP
aP
aO
as
ae
as
as
as
aO
JT
JT
aR
aH
as
as
as
ae
as
aO
aP
aP
aP
aP
aP
aP
"}
(55,1,1) = {"
aP
aP
aP
aP
aP
aP
aP
aO
wK
aO
as
as
al
aO
JT
JT
JT
aH
as
as
as
aO
al
aO
aP
aP
aP
aP
aP
aP
"}
(56,1,1) = {"
aP
aP
aP
aP
aP
aP
aP
aO
as
ae
as
as
as
aO
JT
JT
JT
aH
as
as
as
ae
as
aO
aP
aP
aP
aP
aP
aP
"}
(57,1,1) = {"
aP
aP
aP
aP
aP
aP
aP
aO
aO
aO
aj
as
aj
aO
aO
aO
aO
aO
aj
as
aj
aO
aO
aO
aP
aP
aP
aP
aP
aP
"}
(58,1,1) = {"
aP
aP
aP
aP
aP
aP
aP
aP
aO
aO
ap
as
aj
aj
aj
aw
aj
aj
aj
as
ap
aO
aO
aP
aP
aP
aP
aP
aP
aP
"}
(59,1,1) = {"
aP
aP
aP
aP
aP
aP
aP
aP
aO
aO
Tl
as
as
as
as
as
as
as
as
as
aT
aO
aO
aP
aP
aP
aP
aP
aP
aP
"}
(60,1,1) = {"
aP
aP
aP
aP
aP
aP
aP
aP
aO
aO
ap
ap
ap
aj
as
as
as
aj
ap
ap
ap
aO
aO
aP
aP
aP
aP
aP
aP
aP
"}
(61,1,1) = {"
aP
aP
aP
aP
aP
aP
aP
aP
aO
aO
aO
aO
aO
aO
mY
aO
mY
aO
aO
aO
aO
aO
aO
aP
aP
aP
aP
aP
aP
aP
"}
(62,1,1) = {"
aP
aP
aP
aP
aP
aP
aP
aP
aO
aO
aO
aO
aO
aO
as
Er
as
aO
aO
aO
aO
aO
aO
aP
aP
aP
aP
aP
aP
aP
"}
(63,1,1) = {"
aP
aP
aP
aP
aP
aP
aP
aP
aP
aP
aP
aP
aP
aO
aO
aO
aO
aO
aP
aP
aP
aP
aP
aP
aP
aP
aP
aP
aP
aP
"}
