//MAP CONVERTED BY dmm2tgm.py THIS HEADER COMMENT PREVENTS RECONVERSION, DO NOT REMOVE
"aa" = (
/turf/open/indestructible/overic,
/area/hangar)
"ab" = (
/obj/structure/overic_light/directional/south,
/obj/structure/table/overic,
/turf/open/indestructible/overic,
/area/hangar)
"ac" = (
/obj/structure/netcable,
/turf/open/indestructible/overic/floor,
/area/hangar)
"ag" = (
/turf/open/indestructible/overic/hangar{
	dir = 4
	},
/area/hangar)
"ah" = (
/obj/structure/netcable/end,
/turf/open/indestructible/overic/hangar{
	dir = 1
	},
/area/hangar)
"ak" = (
/obj/structure/overic_light/floor/hangar,
/turf/open/indestructible/overic,
/area/hangar)
"am" = (
/obj/effect/landmark/outpost/hangar_dock,
/turf/open/indestructible/overic/hangar{
	dir = 10
	},
/area/hangar)
"an" = (
/obj/structure/overic_light/directional/east,
/turf/open/indestructible/overic,
/area/hangar)
"ap" = (
/turf/closed/indestructible/overic,
/area/hangar)
"as" = (
/obj/effect/landmark/outpost/elevator,
/turf/open/indestructible/overic/energy,
/area/hangar)
"at" = (
/obj/machinery/door/overic/public{
	dir = 4
	},
/turf/open/indestructible/overic/floor,
/area/hangar)
"au" = (
/turf/template_noop,
/area/template_noop)
"aw" = (
/obj/structure/overic_light/directional/west,
/turf/open/indestructible/overic,
/area/hangar)
"ax" = (
/turf/open/indestructible/overic/hangar{
	dir = 1
	},
/area/hangar)
"ay" = (
/obj/structure/netcable,
/turf/open/indestructible/overic,
/area/hangar)
"aC" = (
/turf/open/indestructible/overic/hangar{
	dir = 5
	},
/area/hangar)
"aF" = (
/turf/open/indestructible/overic/hangar/middle,
/area/hangar)
"aH" = (
/turf/open/indestructible/overic/hangar{
	dir = 8
	},
/area/hangar)
"aP" = (
/turf/open/indestructible/overic/hangar,
/area/hangar)
"aQ" = (
/obj/structure/overic_light/directional/north,
/obj/structure/table/overic,
/turf/open/indestructible/overic,
/area/hangar)
"aS" = (
/obj/machinery/elevator_call_button{
	pixel_y = 25
	},
/obj/effect/landmark/outpost/elevator_machine,
/turf/open/indestructible/overic,
/area/hangar)
"aT" = (
/obj/structure/overic_light/floor/hangar,
/turf/open/indestructible/overic/floor,
/area/hangar)
"aX" = (
/obj/structure/table/overic,
/turf/open/indestructible/overic,
/area/hangar)
"aY" = (
/obj/structure/netcable/end{
	dir = 1
	},
/turf/open/indestructible/overic/hangar,
/area/hangar)
"aZ" = (
/turf/open/indestructible/overic/floor,
/area/hangar)
"jY" = (
/obj/machinery/door/overic,
/turf/open/indestructible/overic/floor,
/area/hangar)
"qA" = (
/obj/structure/overic_light/directional/east,
/turf/open/indestructible/overic/floor,
/area/hangar)
"wC" = (
/obj/structure/overic_light/directional/north,
/turf/open/indestructible/overic/floor,
/area/hangar)
"AT" = (
/turf/open/indestructible/overic/hangar{
	dir = 9
	},
/area/hangar)
"Be" = (
/obj/structure/overic_light/directional/south,
/turf/open/indestructible/overic/floor,
/area/hangar)
"BE" = (
/obj/machinery/door/airlock,
/obj/effect/landmark/outpost/elevator_machine,
/turf/open/indestructible/overic,
/area/hangar)
"Db" = (
/turf/open/indestructible/overic/hangar{
	dir = 6
	},
/area/hangar)
"Fq" = (
/obj/machinery/door/overic{
	dir = 4
	},
/turf/open/indestructible/overic/floor,
/area/hangar)
"JI" = (
/turf/open/indestructible/overic/energy,
/area/hangar)

(1,1,1) = {"
ap
ap
ap
ap
ap
ap
ap
ap
ap
ap
ap
ap
ap
ap
ap
ap
ap
ap
ap
ap
ap
ap
ap
ap
ap
ap
ap
ap
ap
ap
ap
ap
ap
ap
ap
ap
ap
ap
ap
ap
ap
ap
ap
ap
ap
ap
ap
ap
ap
ap
"}
(2,1,1) = {"
ap
ap
ap
ap
ap
ap
ap
ap
ap
ap
ap
ap
ap
ap
ap
ap
ap
ap
ap
ap
ap
ap
ap
ap
ap
ap
ap
ap
ap
ap
ap
ap
ap
ap
ap
ap
ap
ap
ap
ap
ap
ap
ap
ap
ap
ap
ap
ap
ap
ap
"}
(3,1,1) = {"
ap
ap
aa
aa
aa
aa
aa
aa
aa
aa
aa
aa
aa
aa
aa
aa
aa
aa
aa
aa
aa
aa
aa
aa
aa
aa
aa
aa
aa
aa
aa
aa
aa
aa
aa
aa
aa
aa
aa
aa
aa
aa
aa
aa
aa
aa
aa
aa
ap
ap
"}
(4,1,1) = {"
ap
ap
aa
aZ
aZ
aZ
aZ
aZ
aZ
aZ
aZ
aZ
aZ
aZ
aZ
aZ
aZ
aZ
aZ
aZ
aZ
aZ
aZ
aZ
aZ
aZ
aZ
aZ
aZ
aZ
aZ
aZ
aZ
aZ
aZ
aZ
aZ
aZ
aZ
aZ
aZ
aZ
aZ
aZ
aZ
aZ
aZ
aa
ap
ap
"}
(5,1,1) = {"
ap
ap
aa
aZ
aZ
aZ
aZ
aZ
aZ
aZ
aZ
aZ
aZ
aZ
aZ
aZ
aZ
aZ
aZ
aZ
aZ
aZ
aZ
aZ
aZ
aZ
aZ
aZ
aZ
aZ
aZ
aZ
aZ
aZ
aZ
aZ
aZ
aZ
aZ
aZ
aZ
aZ
aZ
aZ
aZ
aZ
aZ
aa
ap
ap
"}
(6,1,1) = {"
ap
ap
aa
aZ
aZ
AT
aH
aH
aH
aH
aH
aH
aH
aH
aH
aH
aH
aH
aH
aH
aH
aH
aH
aH
aH
aH
aH
aH
aH
aH
aH
aH
aH
aH
aH
aH
aH
aH
aH
aH
aH
aH
aH
aH
am
aZ
aZ
aa
ap
ap
"}
(7,1,1) = {"
ap
ap
ay
ac
ac
ah
aF
aF
aF
aF
aF
aF
aF
aF
aF
aF
aF
aF
aF
aF
aF
aF
aF
aF
aF
aF
aF
aF
aF
aF
aF
aF
aF
aF
aF
aF
aF
aF
aF
aF
aF
aF
aF
aF
aY
ac
ac
ay
ap
ap
"}
(8,1,1) = {"
ap
ap
aa
aZ
aZ
ax
aF
aF
aF
aF
aF
aF
aF
aF
aF
aF
aF
aF
aF
aF
aF
aF
aF
aF
aF
aF
aF
aF
aF
aF
aF
aF
aF
aF
aF
aF
aF
aF
aF
aF
aF
aF
aF
aF
aP
aZ
aZ
aa
ap
ap
"}
(9,1,1) = {"
ap
ap
aa
aZ
aZ
ax
aF
aF
aF
aF
aF
aF
aF
aF
aF
aF
aF
aF
aF
aF
aF
aF
aF
aF
aF
aF
aF
aF
aF
aF
aF
aF
aF
aF
aF
aF
aF
aF
aF
aF
aF
aF
aF
aF
aP
aZ
aZ
aa
ap
ap
"}
(10,1,1) = {"
ap
ap
aa
aZ
aT
ax
aF
aF
aF
aF
aF
aF
aF
aF
aF
aF
aF
aF
aF
aF
aF
aF
aF
aF
aF
aF
aF
aF
aF
aF
aF
aF
aF
aF
aF
aF
aF
aF
aF
aF
aF
aF
aF
aF
aP
aT
aZ
aa
ap
ap
"}
(11,1,1) = {"
ap
ap
aa
aZ
aZ
ax
aF
aF
aF
aF
aF
aF
aF
aF
aF
aF
aF
aF
aF
aF
aF
aF
aF
aF
aF
aF
aF
aF
aF
aF
aF
aF
aF
aF
aF
aF
aF
aF
aF
aF
aF
aF
aF
aF
aP
aZ
aZ
aa
ap
ap
"}
(12,1,1) = {"
ap
ap
aa
aZ
aZ
ax
aF
aF
aF
aF
aF
aF
aF
aF
aF
aF
aF
aF
aF
aF
aF
aF
aF
aF
aF
aF
aF
aF
aF
aF
aF
aF
aF
aF
aF
aF
aF
aF
aF
aF
aF
aF
aF
aF
aP
aZ
aZ
aa
ap
ap
"}
(13,1,1) = {"
ap
ap
ay
ac
ac
ah
aF
aF
aF
aF
aF
aF
aF
aF
aF
aF
aF
aF
aF
aF
aF
aF
aF
aF
aF
aF
aF
aF
aF
aF
aF
aF
aF
aF
aF
aF
aF
aF
aF
aF
aF
aF
aF
aF
aY
ac
ac
ay
ap
ap
"}
(14,1,1) = {"
ap
ap
aa
aZ
aZ
ax
aF
aF
aF
aF
aF
aF
aF
aF
aF
aF
aF
aF
aF
aF
aF
aF
aF
aF
aF
aF
aF
aF
aF
aF
aF
aF
aF
aF
aF
aF
aF
aF
aF
aF
aF
aF
aF
aF
aP
aZ
aZ
aa
ap
ap
"}
(15,1,1) = {"
ap
ap
aa
aZ
aZ
ax
aF
aF
aF
aF
aF
aF
aF
aF
aF
aF
aF
aF
aF
aF
aF
aF
aF
aF
aF
aF
aF
aF
aF
aF
aF
aF
aF
aF
aF
aF
aF
aF
aF
aF
aF
aF
aF
aF
aP
aZ
aZ
aa
ap
ap
"}
(16,1,1) = {"
ap
ap
aa
aZ
aZ
ax
aF
aF
aF
aF
aF
aF
aF
aF
aF
aF
aF
aF
aF
aF
aF
aF
aF
aF
aF
aF
aF
aF
aF
aF
aF
aF
aF
aF
aF
aF
aF
aF
aF
aF
aF
aF
aF
aF
aP
aZ
aZ
aa
ap
ap
"}
(17,1,1) = {"
ap
ap
ay
ac
ac
ah
aF
aF
aF
aF
aF
aF
aF
aF
aF
aF
aF
aF
aF
aF
aF
aF
aF
aF
aF
aF
aF
aF
aF
aF
aF
aF
aF
aF
aF
aF
aF
aF
aF
aF
aF
aF
aF
aF
aY
ac
ac
ay
ap
ap
"}
(18,1,1) = {"
ap
ap
aa
aZ
aZ
ax
aF
aF
aF
aF
aF
aF
aF
aF
aF
aF
aF
aF
aF
aF
aF
aF
aF
aF
aF
aF
aF
aF
aF
aF
aF
aF
aF
aF
aF
aF
aF
aF
aF
aF
aF
aF
aF
aF
aP
aZ
aZ
aa
ap
ap
"}
(19,1,1) = {"
ap
ap
aa
aZ
aZ
ax
aF
aF
aF
aF
aF
aF
aF
aF
aF
aF
aF
aF
aF
aF
aF
aF
aF
aF
aF
aF
aF
aF
aF
aF
aF
aF
aF
aF
aF
aF
aF
aF
aF
aF
aF
aF
aF
aF
aP
aZ
aZ
aa
ap
ap
"}
(20,1,1) = {"
ap
ap
aa
aZ
aT
ax
aF
aF
aF
aF
aF
aF
aF
aF
aF
aF
aF
aF
aF
aF
aF
aF
aF
aF
aF
aF
aF
aF
aF
aF
aF
aF
aF
aF
aF
aF
aF
aF
aF
aF
aF
aF
aF
aF
aP
aT
aZ
aa
ap
ap
"}
(21,1,1) = {"
ap
ap
aa
aZ
aZ
ax
aF
aF
aF
aF
aF
aF
aF
aF
aF
aF
aF
aF
aF
aF
aF
aF
aF
aF
aF
aF
aF
aF
aF
aF
aF
aF
aF
aF
aF
aF
aF
aF
aF
aF
aF
aF
aF
aF
aP
aZ
aZ
aa
ap
ap
"}
(22,1,1) = {"
ap
ap
aa
aZ
aZ
ax
aF
aF
aF
aF
aF
aF
aF
aF
aF
aF
aF
aF
aF
aF
aF
aF
aF
aF
aF
aF
aF
aF
aF
aF
aF
aF
aF
aF
aF
aF
aF
aF
aF
aF
aF
aF
aF
aF
aP
aZ
aZ
aa
ap
ap
"}
(23,1,1) = {"
ap
ap
ay
ac
ac
ah
aF
aF
aF
aF
aF
aF
aF
aF
aF
aF
aF
aF
aF
aF
aF
aF
aF
aF
aF
aF
aF
aF
aF
aF
aF
aF
aF
aF
aF
aF
aF
aF
aF
aF
aF
aF
aF
aF
aY
ac
ac
ay
ap
ap
"}
(24,1,1) = {"
ap
ap
aa
aZ
aZ
ax
aF
aF
aF
aF
aF
aF
aF
aF
aF
aF
aF
aF
aF
aF
aF
aF
aF
aF
aF
aF
aF
aF
aF
aF
aF
aF
aF
aF
aF
aF
aF
aF
aF
aF
aF
aF
aF
aF
aP
aZ
aZ
aa
ap
ap
"}
(25,1,1) = {"
ap
ap
aa
aZ
aZ
ax
aF
aF
aF
aF
aF
aF
aF
aF
aF
aF
aF
aF
aF
aF
aF
aF
aF
aF
aF
aF
aF
aF
aF
aF
aF
aF
aF
aF
aF
aF
aF
aF
aF
aF
aF
aF
aF
aF
aP
aZ
aZ
aa
ap
ap
"}
(26,1,1) = {"
ap
ap
aa
aZ
aZ
ax
aF
aF
aF
aF
aF
aF
aF
aF
aF
aF
aF
aF
aF
aF
aF
aF
aF
aF
aF
aF
aF
aF
aF
aF
aF
aF
aF
aF
aF
aF
aF
aF
aF
aF
aF
aF
aF
aF
aP
aZ
aZ
aa
ap
ap
"}
(27,1,1) = {"
ap
ap
ay
ac
ac
ah
aF
aF
aF
aF
aF
aF
aF
aF
aF
aF
aF
aF
aF
aF
aF
aF
aF
aF
aF
aF
aF
aF
aF
aF
aF
aF
aF
aF
aF
aF
aF
aF
aF
aF
aF
aF
aF
aF
aY
ac
ac
ay
ap
ap
"}
(28,1,1) = {"
ap
ap
aa
aZ
aZ
ax
aF
aF
aF
aF
aF
aF
aF
aF
aF
aF
aF
aF
aF
aF
aF
aF
aF
aF
aF
aF
aF
aF
aF
aF
aF
aF
aF
aF
aF
aF
aF
aF
aF
aF
aF
aF
aF
aF
aP
aZ
aZ
aa
ap
ap
"}
(29,1,1) = {"
ap
ap
aa
aZ
aZ
ax
aF
aF
aF
aF
aF
aF
aF
aF
aF
aF
aF
aF
aF
aF
aF
aF
aF
aF
aF
aF
aF
aF
aF
aF
aF
aF
aF
aF
aF
aF
aF
aF
aF
aF
aF
aF
aF
aF
aP
aZ
aZ
aa
ap
ap
"}
(30,1,1) = {"
ap
ap
aa
aZ
aT
ax
aF
aF
aF
aF
aF
aF
aF
aF
aF
aF
aF
aF
aF
aF
aF
aF
aF
aF
aF
aF
aF
aF
aF
aF
aF
aF
aF
aF
aF
aF
aF
aF
aF
aF
aF
aF
aF
aF
aP
aT
aZ
aa
ap
ap
"}
(31,1,1) = {"
ap
ap
aa
aZ
aZ
ax
aF
aF
aF
aF
aF
aF
aF
aF
aF
aF
aF
aF
aF
aF
aF
aF
aF
aF
aF
aF
aF
aF
aF
aF
aF
aF
aF
aF
aF
aF
aF
aF
aF
aF
aF
aF
aF
aF
aP
aZ
aZ
aa
ap
ap
"}
(32,1,1) = {"
ap
ap
aa
aZ
aZ
ax
aF
aF
aF
aF
aF
aF
aF
aF
aF
aF
aF
aF
aF
aF
aF
aF
aF
aF
aF
aF
aF
aF
aF
aF
aF
aF
aF
aF
aF
aF
aF
aF
aF
aF
aF
aF
aF
aF
aP
aZ
aZ
aa
ap
ap
"}
(33,1,1) = {"
ap
ap
ay
ac
ac
ah
aF
aF
aF
aF
aF
aF
aF
aF
aF
aF
aF
aF
aF
aF
aF
aF
aF
aF
aF
aF
aF
aF
aF
aF
aF
aF
aF
aF
aF
aF
aF
aF
aF
aF
aF
aF
aF
aF
aY
ac
ac
ay
ap
ap
"}
(34,1,1) = {"
ap
ap
aa
aZ
aZ
ax
aF
aF
aF
aF
aF
aF
aF
aF
aF
aF
aF
aF
aF
aF
aF
aF
aF
aF
aF
aF
aF
aF
aF
aF
aF
aF
aF
aF
aF
aF
aF
aF
aF
aF
aF
aF
aF
aF
aP
aZ
aZ
aa
ap
ap
"}
(35,1,1) = {"
ap
ap
aa
aZ
aZ
ax
aF
aF
aF
aF
aF
aF
aF
aF
aF
aF
aF
aF
aF
aF
aF
aF
aF
aF
aF
aF
aF
aF
aF
aF
aF
aF
aF
aF
aF
aF
aF
aF
aF
aF
aF
aF
aF
aF
aP
aZ
aZ
aa
ap
ap
"}
(36,1,1) = {"
ap
ap
aa
aZ
aZ
ax
aF
aF
aF
aF
aF
aF
aF
aF
aF
aF
aF
aF
aF
aF
aF
aF
aF
aF
aF
aF
aF
aF
aF
aF
aF
aF
aF
aF
aF
aF
aF
aF
aF
aF
aF
aF
aF
aF
aP
aZ
aZ
aa
ap
ap
"}
(37,1,1) = {"
ap
ap
ay
ac
ac
ah
aF
aF
aF
aF
aF
aF
aF
aF
aF
aF
aF
aF
aF
aF
aF
aF
aF
aF
aF
aF
aF
aF
aF
aF
aF
aF
aF
aF
aF
aF
aF
aF
aF
aF
aF
aF
aF
aF
aY
ac
ac
ay
ap
ap
"}
(38,1,1) = {"
ap
ap
aa
aZ
aZ
ax
aF
aF
aF
aF
aF
aF
aF
aF
aF
aF
aF
aF
aF
aF
aF
aF
aF
aF
aF
aF
aF
aF
aF
aF
aF
aF
aF
aF
aF
aF
aF
aF
aF
aF
aF
aF
aF
aF
aP
aZ
aZ
aa
ap
ap
"}
(39,1,1) = {"
ap
ap
aa
aZ
aZ
ax
aF
aF
aF
aF
aF
aF
aF
aF
aF
aF
aF
aF
aF
aF
aF
aF
aF
aF
aF
aF
aF
aF
aF
aF
aF
aF
aF
aF
aF
aF
aF
aF
aF
aF
aF
aF
aF
aF
aP
aZ
aZ
aa
ap
ap
"}
(40,1,1) = {"
ap
ap
aa
aZ
aT
ax
aF
aF
aF
aF
aF
aF
aF
aF
aF
aF
aF
aF
aF
aF
aF
aF
aF
aF
aF
aF
aF
aF
aF
aF
aF
aF
aF
aF
aF
aF
aF
aF
aF
aF
aF
aF
aF
aF
aP
aT
aZ
aa
ap
ap
"}
(41,1,1) = {"
ap
ap
aa
aZ
aZ
ax
aF
aF
aF
aF
aF
aF
aF
aF
aF
aF
aF
aF
aF
aF
aF
aF
aF
aF
aF
aF
aF
aF
aF
aF
aF
aF
aF
aF
aF
aF
aF
aF
aF
aF
aF
aF
aF
aF
aP
aZ
aZ
aa
ap
ap
"}
(42,1,1) = {"
ap
ap
aa
aZ
aZ
ax
aF
aF
aF
aF
aF
aF
aF
aF
aF
aF
aF
aF
aF
aF
aF
aF
aF
aF
aF
aF
aF
aF
aF
aF
aF
aF
aF
aF
aF
aF
aF
aF
aF
aF
aF
aF
aF
aF
aP
aZ
aZ
aa
ap
ap
"}
(43,1,1) = {"
ap
ap
ay
ac
ac
ah
aF
aF
aF
aF
aF
aF
aF
aF
aF
aF
aF
aF
aF
aF
aF
aF
aF
aF
aF
aF
aF
aF
aF
aF
aF
aF
aF
aF
aF
aF
aF
aF
aF
aF
aF
aF
aF
aF
aY
ac
ac
ay
ap
ap
"}
(44,1,1) = {"
ap
ap
aa
aZ
aZ
ax
aF
aF
aF
aF
aF
aF
aF
aF
aF
aF
aF
aF
aF
aF
aF
aF
aF
aF
aF
aF
aF
aF
aF
aF
aF
aF
aF
aF
aF
aF
aF
aF
aF
aF
aF
aF
aF
aF
aP
aZ
aZ
aa
ap
ap
"}
(45,1,1) = {"
ap
ap
aa
aZ
aZ
aC
ag
ag
ag
ag
ag
ag
ag
ag
ag
ag
ag
ag
ag
ag
ag
ag
ag
ag
ag
ag
ag
ag
ag
ag
ag
ag
ag
ag
ag
ag
ag
ag
ag
ag
ag
ag
ag
ag
Db
aZ
aZ
aa
ap
ap
"}
(46,1,1) = {"
ap
ap
aa
aZ
aZ
aZ
aZ
aZ
aZ
aZ
aZ
aZ
aZ
aZ
aZ
aZ
aZ
aZ
aZ
aZ
aZ
aZ
aZ
aZ
aZ
aZ
aZ
aZ
aZ
aZ
aZ
aZ
aZ
aZ
aZ
aZ
aZ
aZ
aZ
aZ
aZ
aZ
aZ
aZ
aZ
aZ
aZ
aa
ap
ap
"}
(47,1,1) = {"
ap
ap
aa
aZ
aZ
aZ
aZ
aZ
aZ
aZ
aZ
aZ
aZ
aZ
aZ
aZ
aZ
aZ
aZ
aZ
aZ
aZ
aZ
aZ
aZ
aZ
aZ
aZ
aZ
aZ
aZ
aZ
aZ
aZ
aZ
aZ
aZ
aZ
aZ
aZ
aZ
aZ
aZ
aZ
aZ
aZ
aZ
aa
ap
ap
"}
(48,1,1) = {"
ap
ap
aa
aa
aa
ak
aa
aa
aa
aa
aa
aa
aa
aa
aa
ak
aa
aa
aa
aa
aa
aa
aa
aa
ak
ak
aa
aa
aa
aa
aa
aa
aa
aa
ak
aa
aa
aa
aa
aa
aa
aa
aa
aa
ak
aa
aa
aa
ap
ap
"}
(49,1,1) = {"
ap
ap
ap
ap
ap
ap
ap
ap
ap
ap
ap
ap
ap
ap
ap
ap
ap
ap
ap
ap
ap
ap
ap
ap
at
ap
at
ap
ap
ap
ap
ap
ap
ap
ap
ap
ap
ap
ap
ap
ap
ap
ap
ap
ap
ap
ap
ap
ap
ap
"}
(50,1,1) = {"
ap
ap
ap
ap
ap
ap
ap
ap
ap
ap
ap
ap
ap
ap
ap
ap
ap
ap
ap
ap
aX
aX
aX
aa
aZ
aZ
aZ
aa
aX
aX
aX
ap
ap
ap
ap
ap
ap
ap
ap
ap
ap
ap
ap
ap
ap
ap
ap
ap
ap
ap
"}
(51,1,1) = {"
au
au
au
au
au
au
au
au
au
au
au
au
au
au
au
au
au
au
ap
ap
aQ
aZ
aZ
aZ
aZ
aZ
aZ
aZ
aZ
aZ
ab
ap
ap
au
au
au
au
au
au
au
au
au
au
au
au
au
au
au
au
au
"}
(52,1,1) = {"
au
au
au
au
au
au
au
au
au
au
au
au
au
au
au
au
au
au
ap
ap
aX
aZ
aa
aa
aa
an
aa
aa
aa
aZ
aX
ap
ap
au
au
au
au
au
au
au
au
au
au
au
au
au
au
au
au
au
"}
(53,1,1) = {"
au
au
au
au
au
au
au
au
au
au
au
au
au
au
au
au
au
ap
ap
ap
aa
aZ
aa
ap
ap
ap
ap
ap
aS
aZ
aa
ap
ap
ap
au
au
au
au
au
au
au
au
au
au
au
au
au
au
au
au
"}
(54,1,1) = {"
au
au
au
au
au
au
au
au
au
au
au
au
au
au
au
au
au
ap
aZ
jY
aZ
aZ
aZ
ap
JI
JI
as
BE
aZ
aZ
aZ
jY
aZ
ap
au
au
au
au
au
au
au
au
au
au
au
au
au
au
au
au
"}
(55,1,1) = {"
au
au
au
au
au
au
au
au
au
au
au
au
au
au
au
au
au
ap
wC
ap
aZ
aZ
Be
ap
JI
JI
JI
BE
aZ
aZ
aZ
ap
Be
ap
au
au
au
au
au
au
au
au
au
au
au
au
au
au
au
au
"}
(56,1,1) = {"
au
au
au
au
au
au
au
au
au
au
au
au
au
au
au
au
au
ap
aZ
jY
aZ
aZ
aZ
ap
JI
JI
JI
BE
aZ
aZ
aZ
jY
aZ
ap
au
au
au
au
au
au
au
au
au
au
au
au
au
au
au
au
"}
(57,1,1) = {"
au
au
au
au
au
au
au
au
au
au
au
au
au
au
au
au
au
ap
ap
ap
aa
aZ
aa
ap
ap
ap
ap
ap
aa
aZ
aa
ap
ap
ap
au
au
au
au
au
au
au
au
au
au
au
au
au
au
au
au
"}
(58,1,1) = {"
au
au
au
au
au
au
au
au
au
au
au
au
au
au
au
au
au
au
ap
ap
aX
aZ
aa
aa
aa
aw
aa
aa
aa
aZ
aX
ap
ap
au
au
au
au
au
au
au
au
au
au
au
au
au
au
au
au
au
"}
(59,1,1) = {"
au
au
au
au
au
au
au
au
au
au
au
au
au
au
au
au
au
au
ap
ap
aQ
aZ
aZ
aZ
aZ
aZ
aZ
aZ
aZ
aZ
ab
ap
ap
au
au
au
au
au
au
au
au
au
au
au
au
au
au
au
au
au
"}
(60,1,1) = {"
au
au
au
au
au
au
au
au
au
au
au
au
au
au
au
au
au
au
ap
ap
aX
aX
aX
aa
aZ
aZ
aZ
aa
aX
aX
aX
ap
ap
au
au
au
au
au
au
au
au
au
au
au
au
au
au
au
au
au
"}
(61,1,1) = {"
au
au
au
au
au
au
au
au
au
au
au
au
au
au
au
au
au
au
ap
ap
ap
ap
ap
ap
Fq
ap
Fq
ap
ap
ap
ap
ap
ap
au
au
au
au
au
au
au
au
au
au
au
au
au
au
au
au
au
"}
(62,1,1) = {"
au
au
au
au
au
au
au
au
au
au
au
au
au
au
au
au
au
au
ap
ap
ap
ap
ap
ap
aZ
qA
aZ
ap
ap
ap
ap
ap
ap
au
au
au
au
au
au
au
au
au
au
au
au
au
au
au
au
au
"}
(63,1,1) = {"
au
au
au
au
au
au
au
au
au
au
au
au
au
au
au
au
au
au
au
au
au
au
au
ap
ap
ap
ap
ap
au
au
au
au
au
au
au
au
au
au
au
au
au
au
au
au
au
au
au
au
au
au
"}
