"an" = (/turf/closed/indestructible/syndicate,/area/ship/medical)
"bv" = (/obj/machinery/atmospherics/pipe/simple/scrubbers/hidden/layer4{dir = 9},/obj/machinery/atmospherics/pipe/simple/supply/hidden/layer2{dir = 5},/turf/open/floor/plasteel/white,/area/ship/medical)
"bS" = (/obj/machinery/atmospherics/components/unary/vent_scrubber/on/layer4{dir = 1},/turf/open/floor/mineral/abductor,/area/ship/archonic)
"bT" = (/obj/effect/turf_decal/corner/opaque/black/half{dir = 8},/obj/effect/turf_decal/corner/opaque/black/bordercorner{dir = 4},/turf/open/floor/plasteel/tech,/area/ship/engineering)
"cd" = (/turf/closed/indestructible/syndicate,/area/ship/engineering)
"ch" = (/turf/closed/indestructible/alien,/area/ship/engineering)
"cl" = (/obj/structure/table/reinforced,/obj/item/wrench/medical,/obj/machinery/light/directional/west,/turf/open/floor/plasteel/white,/area/ship/medical)
"cx" = (/turf/closed/indestructible/syndicate,/area/ship/storage/eva)
"cG" = (/obj/effect/turf_decal/corner/opaque/black/bordercorner{dir = 4},/turf/open/floor/plasteel/tech/grid,/area/ship/engineering)
"cH" = (/obj/machinery/door/poddoor/shutters/indestructible{id = "termcshutter"; dir = 4},/turf/closed/indestructible/opsglass,/area/ship/bridge)
"cI" = (/obj/structure/table/reinforced,/obj/item/storage/backpack/duffelbag/syndie/surgery,/turf/open/floor/plasteel/white,/area/ship/medical)
"eb" = (/obj/structure/cable{icon_state = "1-10"},/obj/machinery/atmospherics/pipe/simple/supply/hidden/layer2,/obj/effect/turf_decal/corner/opaque/solgovblue/three_quarters{dir = 8},/turf/open/floor/plasteel/dark,/area/ship/hallway/central)
"eB" = (/obj/item/storage/secure/briefcase,/obj/structure/table/abductor,/turf/open/floor/plasteel/dark,/area/ship/crew)
"eU" = (/obj/machinery/atmospherics/pipe/simple/scrubbers/hidden/layer4,/obj/machinery/atmospherics/pipe/simple/supply/hidden/layer2,/turf/open/floor/plasteel/white,/area/ship/medical)
"eV" = (/obj/effect/turf_decal/corner/opaque/black/bordercorner,/turf/open/floor/plasteel/tech/grid,/area/ship/engineering)
"fe" = (/obj/structure/table/reinforced,/obj/machinery/atmospherics/pipe/simple/scrubbers/hidden/layer4{dir = 6},/obj/machinery/atmospherics/pipe/simple/supply/hidden/layer2{dir = 6},/obj/item/storage/firstaid/tactical,/obj/item/storage/firstaid/advanced,/obj/item/storage/firstaid/medical,/obj/item/storage/firstaid/radiation,/obj/item/storage/firstaid/toxin,/obj/effect/turf_decal/industrial/firstaid/cee,/turf/open/floor/plasteel/white,/area/ship/medical)
"fC" = (/turf/open/floor/plasteel/rockvault/alien,/area/ship/engineering)
"fY" = (/obj/machinery/atmospherics/pipe/simple/scrubbers/hidden/layer4{dir = 5},/obj/machinery/atmospherics/pipe/simple/supply/hidden/layer2{dir = 6},/turf/open/floor/plasteel/dark,/area/ship/crew)
"gb" = (/obj/machinery/autolathe/hacked,/obj/effect/turf_decal/corner/opaque/black/half{dir = 1},/obj/effect/turf_decal/corner/opaque/black/bordercorner,/turf/open/floor/plasteel/tech,/area/ship/engineering)
"gp" = (/obj/machinery/atmospherics/pipe/simple/scrubbers/hidden/layer4{dir = 4},/obj/machinery/atmospherics/pipe/simple/supply/hidden/layer2{dir = 4},/obj/effect/turf_decal/corner/opaque/black/mono,/obj/machinery/airalarm/directional/north,/turf/open/floor/plasteel/tech,/area/ship/engineering)
"gN" = (/obj/machinery/rnd/server,/obj/effect/turf_decal/corner/opaque/black/mono,/turf/open/floor/plasteel/tech,/area/ship/engineering)
"hP" = (/obj/machinery/power/rtg/abductor/archonic,/obj/structure/cable{icon_state = "0-4"},/obj/machinery/atmospherics/pipe/simple/supply/hidden/layer2{dir = 6},/turf/open/floor/mineral/abductor,/area/ship/archonic)
"hR" = (/turf/open/floor/plasteel/rockvault/alien,/area/ship/medical)
"ia" = (/obj/machinery/light/directional/east,/obj/machinery/atmospherics/components/unary/vent_pump/on/layer2{dir = 8},/turf/open/floor/plasteel/white,/area/ship/medical)
"il" = (/obj/machinery/computer{icon = 'icons/obj/stationobjs.dmi'; icon_keyboard = null; icon_screen = null; icon_state = "blackbox"; name = "Three Pointed Star Archives"},/turf/open/floor/plasteel/telecomms_floor,/area/ship/engineering)
"io" = (/turf/closed/indestructible/syndicate,/area/ship/archonic)
"it" = (/turf/closed/indestructible/syndicate,/area/ship/crew)
"iG" = (/obj/machinery/door/airlock/survival_pod{name = "Bridge"},/obj/structure/cable{icon_state = "2-5"},/obj/machinery/atmospherics/pipe/simple/scrubbers/hidden/layer4,/turf/open/floor/mineral/plastitanium,/area/ship/bridge)
"iQ" = (/obj/machinery/door/poddoor/shutters/indestructible{id = "termcshutter"; dir = 8},/turf/closed/indestructible/opsglass,/area/ship/bridge)
"iU" = (/obj/structure/table/abductor,/obj/machinery/button/door{id = "termcshutter"; name = "Cockpit Shutters"},/turf/open/floor/mineral/plastitanium,/area/ship/bridge)
"jA" = (/obj/machinery/atmospherics/components/unary/cryo_cell,/turf/open/floor/plasteel/white,/area/ship/medical)
"jI" = (/obj/machinery/power/shuttle/engine/void,/turf/open/floor/plating,/area/ship/medical)
"jQ" = (/obj/structure/cable{icon_state = "2-8"},/obj/machinery/atmospherics/pipe/simple/scrubbers/hidden/layer4{dir = 4},/obj/machinery/atmospherics/pipe/simple/supply/hidden/layer2{dir = 4},/turf/open/floor/plasteel/dark,/area/ship/storage/eva)
"km" = (/obj/machinery/telecomms/allinone,/turf/open/floor/plasteel/telecomms_floor,/area/ship/engineering)
"ks" = (/obj/structure/cable,/obj/machinery/power/apc/auto_name/directional/west,/turf/open/floor/plasteel/dark,/area/ship/storage/eva)
"kF" = (/obj/structure/cable{icon_state = "0-4"},/obj/machinery/atmospherics/pipe/simple/supply/hidden/layer2{dir = 4},/obj/machinery/atmospherics/pipe/simple/scrubbers/hidden/layer4{dir = 4},/obj/machinery/power/apc/auto_name/directional/north,/turf/open/floor/plasteel/stairs{dir = 8},/area/ship/medical)
"ld" = (/obj/structure/cable{icon_state = "2-5"},/obj/structure/cable{icon_state = "2-9"},/obj/machinery/atmospherics/pipe/simple/supply/hidden/layer2{dir = 6},/obj/machinery/atmospherics/pipe/simple/scrubbers/hidden/layer4{dir = 10},/turf/open/floor/plating/catwalk_floor,/area/ship/hallway/central)
"le" = (/obj/effect/turf_decal/corner/opaque/black/half{dir = 4},/turf/open/floor/plasteel/tech,/area/ship/engineering)
"lg" = (/obj/machinery/rnd/production/techfab,/obj/effect/turf_decal/corner/opaque/black/mono,/turf/open/floor/plasteel/tech,/area/ship/engineering)
"lp" = (/obj/machinery/suit_storage_unit/inherit,/obj/item/tank/internals/emergency_oxygen/double,/obj/item/clothing/mask/nobreath,/obj/item/clothing/suit/space/hardsuit/quixote/dimensional,/turf/open/floor/plasteel/dark,/area/ship/storage/eva)
"lz" = (/obj/structure/window/reinforced/survival_pod/spawner/north,/turf/open/floor/plasteel/telecomms_floor,/area/ship/engineering)
"lM" = (/turf/open/floor/plating/abductor,/area/ship/archonic)
"lS" = (/obj/machinery/atmospherics/components/unary/vent_scrubber/on/layer4,/turf/open/floor/plasteel/dark,/area/ship/crew)
"lY" = (/obj/effect/turf_decal/corner/opaque/solgovblue/half{dir = 8},/turf/open/floor/plasteel/dark,/area/ship/hallway/central)
"mg" = (/obj/structure/chair/comfy/shuttle{dir = 8},/turf/open/floor/plasteel/dark,/area/ship/storage/eva)
"mj" = (/obj/machinery/atmospherics/pipe/simple/supply/hidden/layer2{dir = 9},/obj/effect/turf_decal/corner/opaque/solgovblue/half{dir = 4},/turf/open/floor/plasteel/dark,/area/ship/hallway/central)
"mW" = (/obj/machinery/atmospherics/components/unary/vent_pump/on/layer2{dir = 1},/turf/open/floor/plasteel/dark,/area/ship/storage/eva)
"mZ" = (/obj/structure/cable{icon_state = "4-8"},/obj/machinery/atmospherics/pipe/simple/supply/hidden/layer2{dir = 4},/obj/machinery/atmospherics/pipe/simple/scrubbers/hidden/layer4{dir = 4},/obj/effect/turf_decal/corner/opaque/solgovblue/three_quarters,/turf/open/floor/plasteel/dark,/area/ship/hallway/central)
"ny" = (/obj/machinery/recharge_station,/obj/effect/turf_decal/corner/opaque/black/half,/obj/effect/turf_decal/corner/opaque/black/bordercorner{dir = 1},/turf/open/floor/plasteel/tech,/area/ship/engineering)
"nT" = (/obj/structure/closet/cabinet,/obj/item/clothing/under/syndicate/skirt,/obj/item/clothing/under/syndicate/skirt/maid,/obj/item/clothing/under/syndicate/skirt/maid,/obj/item/clothing/under/syndicate/skirt/maid,/obj/item/clothing/under/syndicate/skirt,/obj/item/clothing/under/syndicate/skirt,/obj/item/clothing/under/syndicate/tacticool/skirt,/obj/item/clothing/under/syndicate/tacticool/skirt,/obj/item/clothing/under/syndicate/tacticool/skirt,/obj/item/clothing/shoes/jackboots,/obj/item/clothing/shoes/jackboots,/obj/item/clothing/shoes/jackboots,/obj/item/clothing/gloves/combat,/obj/item/clothing/gloves/combat,/obj/item/clothing/gloves/combat,/obj/item/clothing/gloves/combat/maid,/obj/item/clothing/head/maidheadband/syndicate,/turf/open/floor/plasteel/dark,/area/ship/crew)
"pQ" = (/obj/machinery/button/door{dir = 4; pixel_y = 6; pixel_x = -22; id = "termbedshutter"; name = "Privacy Shutters"},/turf/open/floor/plasteel/dark,/area/ship/crew)
"qD" = (/obj/structure/table/optable,/turf/open/floor/plasteel/white,/area/ship/medical)
"qO" = (/obj/machinery/atmospherics/components/unary/vent_scrubber/on/layer4{dir = 8},/turf/open/floor/plasteel/tech/grid,/area/ship/engineering)
"rb" = (/obj/machinery/light/directional/west,/turf/open/floor/plasteel/dark,/area/ship/crew)
"rm" = (/obj/machinery/atmospherics/components/unary/thermomachine/freezer,/turf/open/floor/plasteel/white,/area/ship/medical)
"sw" = (/obj/machinery/computer/launchpad{dir = 1},/turf/open/floor/plating/abductor,/area/ship/archonic)
"tP" = (/obj/structure/cable{icon_state = "1-2"},/obj/machinery/atmospherics/pipe/simple/supply/hidden/layer2,/obj/machinery/atmospherics/pipe/simple/scrubbers/hidden/layer4,/turf/open/floor/plating/catwalk_floor,/area/ship/hallway/central)
"tQ" = (/obj/structure/fans/tiny,/obj/machinery/door/namedoor{dir = 8; name = "Terminal Access Point"},/obj/docking_port/mobile{can_move_docking_ports = 1; dir = 8; launch_status = 0; port_direction = 4},/turf/open/floor/plating,/area/ship/storage/eva)
"tU" = (/obj/machinery/atmospherics/components/unary/vent_pump/on/layer2{dir = 4},/obj/effect/turf_decal/corner/opaque/black/half{dir = 8},/obj/machinery/mission_scanner,/turf/open/floor/plasteel/tech,/area/ship/engineering)
"ug" = (/obj/machinery/atmospherics/components/unary/vent_scrubber/on/layer4,/obj/structure/chair/comfy/shuttle{dir = 1},/turf/open/floor/mineral/plastitanium,/area/ship/bridge)
"uY" = (/obj/machinery/door/airlock/survival_pod/glass{name = "EVA"; dir = 8},/obj/structure/cable{icon_state = "4-8"},/obj/machinery/atmospherics/pipe/simple/scrubbers/hidden/layer4{dir = 4},/obj/machinery/atmospherics/pipe/simple/supply/hidden/layer2{dir = 4},/turf/open/floor/plasteel/mono/dark,/area/ship/storage/eva)
"vg" = (/obj/structure/cable{icon_state = "1-2"},/obj/machinery/atmospherics/pipe/simple/scrubbers/hidden/layer4,/obj/machinery/atmospherics/pipe/simple/scrubbers/hidden/layer4,/obj/machinery/atmospherics/pipe/simple/supply/hidden/layer2,/turf/open/floor/plating/catwalk_floor,/area/ship/hallway/central)
"vs" = (/obj/effect/turf_decal/corner/opaque/solgovblue/half{dir = 1},/turf/open/floor/plasteel/dark,/area/ship/hallway/central)
"wJ" = (/obj/item/archonic/interface_system,/obj/structure/table/abductor,/turf/open/floor/plasteel/dark,/area/ship/crew)
"xn" = (/obj/machinery/chem_heater,/turf/open/floor/plasteel/white,/area/ship/medical)
"xs" = (/obj/structure/cable{icon_state = "0-8"},/obj/machinery/power/apc/auto_name/directional/north,/obj/machinery/atmospherics/pipe/simple/scrubbers/hidden/layer4{dir = 10},/obj/machinery/airalarm/directional/east,/turf/open/floor/mineral/abductor,/area/ship/archonic)
"xG" = (/obj/structure/cable{icon_state = "1-2"},/obj/structure/cable{icon_state = "2-8"},/obj/structure/cable{icon_state = "2-4"},/obj/machinery/atmospherics/pipe/manifold4w/scrubbers/hidden/layer4,/obj/machinery/atmospherics/pipe/manifold4w/supply/hidden/layer2,/obj/effect/turf_decal/corner/opaque/solgovblue/half,/turf/open/floor/plasteel/dark,/area/ship/hallway/central)
"xU" = (/turf/template_noop,/area/template_noop)
"yb" = (/obj/machinery/light/directional/south,/obj/machinery/airalarm/directional/west,/turf/open/floor/mineral/plastitanium,/area/ship/bridge)
"yd" = (/turf/open/floor/plasteel/white,/area/ship/medical)
"yE" = (/obj/structure/table/abductor,/turf/open/floor/plasteel/dark,/area/ship/storage/eva)
"yJ" = (/obj/structure/cable{icon_state = "4-8"},/obj/machinery/atmospherics/pipe/simple/supply/hidden/layer2{dir = 4},/obj/machinery/atmospherics/pipe/simple/scrubbers/hidden/layer4{dir = 4},/obj/effect/turf_decal/corner/opaque/solgovblue/three_quarters{dir = 1},/turf/open/floor/plasteel/dark,/area/ship/hallway/central)
"yK" = (/obj/structure/cable{icon_state = "0-8"},/obj/machinery/atmospherics/pipe/simple/supply/hidden/layer2{dir = 4},/obj/machinery/atmospherics/pipe/simple/scrubbers/hidden/layer4{dir = 4},/obj/machinery/power/apc/auto_name/directional/north,/turf/open/floor/plasteel/stairs{dir = 4},/area/ship/engineering)
"yM" = (/turf/open/floor/mineral/plastitanium,/area/ship/bridge)
"yO" = (/obj/machinery/computer/camera_advanced/syndie,/turf/open/floor/mineral/plastitanium,/area/ship/bridge)
"zw" = (/obj/machinery/atmospherics/pipe/simple/scrubbers/hidden/layer4,/turf/open/floor/mineral/plastitanium,/area/ship/bridge)
"zx" = (/obj/machinery/atmospherics/pipe/simple/scrubbers/hidden/layer4{dir = 5},/obj/effect/turf_decal/corner/opaque/solgovblue/half{dir = 8},/turf/open/floor/plasteel/dark,/area/ship/hallway/central)
"zy" = (/obj/machinery/door/airlock/survival_pod/glass{name = "Engineering"; dir = 8},/obj/structure/cable{icon_state = "4-8"},/obj/machinery/atmospherics/pipe/simple/supply/hidden/layer2{dir = 4},/obj/machinery/atmospherics/pipe/simple/scrubbers/hidden/layer4{dir = 4},/turf/open/floor/plasteel/mono/dark,/area/ship/engineering)
"zV" = (/obj/effect/turf_decal/corner/opaque/black/half{dir = 4},/obj/effect/turf_decal/corner/opaque/black/bordercorner{dir = 1},/turf/open/floor/plasteel/tech,/area/ship/engineering)
"Ax" = (/obj/machinery/power/shuttle/engine/void,/turf/open/floor/plating,/area/ship/engineering)
"Ay" = (/turf/open/floor/plasteel/dark,/area/ship/storage/eva)
"AK" = (/obj/structure/window/reinforced/survival_pod/spawner/north,/turf/closed/indestructible/alien,/area/ship/medical)
"AY" = (/obj/machinery/door/airlock/survival_pod{name = "Bridge"},/obj/structure/cable{icon_state = "2-9"},/obj/machinery/atmospherics/pipe/simple/supply/hidden/layer2,/turf/open/floor/mineral/plastitanium,/area/ship/bridge)
"Bd" = (/obj/structure/table/abductor,/obj/item/multitool/abductor,/turf/open/floor/plating/abductor,/area/ship/archonic)
"Bl" = (/obj/machinery/computer/helm,/turf/open/floor/mineral/plastitanium,/area/ship/bridge)
"Dc" = (/obj/machinery/atmospherics/components/unary/vent_scrubber/on/layer4{dir = 4},/turf/open/floor/plasteel/white,/area/ship/medical)
"DN" = (/obj/machinery/door/poddoor/shutters/indestructible{dir = 4; id = "termbedshutter"},/turf/closed/indestructible/opsglass,/area/ship/crew)
"FJ" = (/obj/machinery/atmospherics/components/unary/vent_pump/on/layer2{dir = 1},/turf/open/floor/plasteel/dark,/area/ship/crew)
"Ge" = (/obj/structure/table/reinforced,/turf/open/floor/plasteel/white,/area/ship/medical)
"Gh" = (/obj/structure/cable{icon_state = "1-8"},/obj/structure/cable{icon_state = "4-8"},/obj/machinery/atmospherics/pipe/simple/scrubbers/hidden/layer4{dir = 5},/obj/machinery/atmospherics/pipe/simple/supply/hidden/layer2{dir = 9},/turf/open/floor/mineral/abductor,/area/ship/archonic)
"GQ" = (/obj/structure/cable{icon_state = "2-4"},/obj/machinery/atmospherics/pipe/simple/scrubbers/hidden/layer4{dir = 4},/obj/machinery/atmospherics/pipe/simple/supply/hidden/layer2{dir = 4},/turf/open/floor/plasteel/dark,/area/ship/crew)
"Hd" = (/obj/machinery/atmospherics/pipe/simple/scrubbers/hidden/layer4{dir = 4},/obj/machinery/atmospherics/pipe/simple/supply/hidden/layer2{dir = 4},/obj/machinery/airalarm/directional/north,/turf/open/floor/plasteel/white,/area/ship/medical)
"Hq" = (/obj/machinery/light/directional/south,/turf/open/floor/mineral/plastitanium,/area/ship/bridge)
"HB" = (/obj/machinery/ntnet_relay,/turf/open/floor/plasteel/telecomms_floor,/area/ship/engineering)
"HH" = (/obj/machinery/atmospherics/components/unary/vent_scrubber/on/layer4,/turf/open/floor/plasteel/dark,/area/ship/storage/eva)
"HI" = (/obj/machinery/light/directional/west,/obj/effect/turf_decal/corner/opaque/solgovblue/half{dir = 8},/turf/open/floor/plasteel/dark,/area/ship/hallway/central)
"HT" = (/obj/effect/turf_decal/corner/opaque/solgovblue/half{dir = 4},/turf/open/floor/plasteel/dark,/area/ship/hallway/central)
"Ik" = (/obj/machinery/light/directional/east,/obj/effect/turf_decal/corner/opaque/solgovblue/half{dir = 4},/turf/open/floor/plasteel/dark,/area/ship/hallway/central)
"IH" = (/obj/structure/window/reinforced/survival_pod/spawner/north,/turf/closed/indestructible/alien,/area/ship/engineering)
"IR" = (/obj/machinery/launchpad/violetspace,/turf/open/floor/plating/abductor2,/area/ship/archonic)
"Jf" = (/obj/structure/dresser,/obj/item/flashlight/lantern/lamp_of_silence{pixel_y = 14; pixel_x = -2},/turf/open/floor/plasteel/dark,/area/ship/crew)
"Jg" = (/obj/structure/closet/secure_closet/personal{req_access = null; name = "Crux's Armory"},/obj/item/healthanalyzer/rad_laser,/obj/item/multitool/ai_detect,/obj/item/clothing/suit/wizrobe/magusred/archonic,/obj/item/clothing/neck/crystal_amulet/archous,/obj/item/spear/archous,/turf/open/floor/plasteel/dark,/area/ship/crew)
"Jk" = (/obj/item/bedsheet/double/rd,/obj/structure/bed/double,/turf/open/floor/plasteel/dark,/area/ship/crew)
"JD" = (/obj/machinery/chem_dispenser/abductor,/turf/open/floor/plasteel/white,/area/ship/medical)
"JI" = (/obj/structure/cable{icon_state = "2-8"},/obj/structure/cable{icon_state = "2-4"},/obj/structure/cable{icon_state = "1-2"},/obj/machinery/atmospherics/pipe/manifold4w/scrubbers/hidden/layer4,/obj/machinery/atmospherics/pipe/manifold4w/supply/hidden/layer2,/turf/open/floor/plating/catwalk_floor,/area/ship/hallway/central)
"JJ" = (/obj/structure/cable{icon_state = "4-8"},/obj/machinery/atmospherics/pipe/simple/scrubbers/hidden/layer4{dir = 4},/obj/machinery/atmospherics/pipe/simple/supply/hidden/layer2{dir = 4},/obj/effect/turf_decal/corner/opaque/solgovblue/half{dir = 4},/turf/open/floor/plasteel/dark,/area/ship/hallway/central)
"Kz" = (/obj/structure/cable{icon_state = "4-8"},/obj/machinery/atmospherics/pipe/simple/scrubbers/hidden/layer4{dir = 4},/obj/machinery/atmospherics/pipe/simple/supply/hidden/layer2{dir = 4},/obj/effect/turf_decal/corner/opaque/solgovblue/half{dir = 8},/turf/open/floor/plasteel/dark,/area/ship/hallway/central)
"KP" = (/turf/open/floor/mineral/abductor,/area/ship/archonic)
"KS" = (/obj/machinery/door/airlock/abductor{name = "Reliquary"},/obj/structure/cable{icon_state = "1-2"},/obj/machinery/atmospherics/pipe/simple/scrubbers/hidden/layer4,/turf/open/floor/plasteel/mono/dark,/area/ship/archonic)
"Lj" = (/obj/docking_port/stationary{dir = 4; dwidth = 15; height = 15; width = 30},/turf/template_noop,/area/template_noop)
"Ll" = (/obj/machinery/light/directional/east,/obj/structure/chair/comfy/shuttle{dir = 8},/turf/open/floor/plasteel/dark,/area/ship/storage/eva)
"Lt" = (/obj/structure/grille,/obj/structure/lattice/catwalk,/turf/template_noop,/area/ship/external)
"LC" = (/obj/structure/cable{icon_state = "1-6"},/obj/machinery/atmospherics/pipe/simple/scrubbers/hidden/layer4,/obj/effect/turf_decal/corner/opaque/solgovblue/three_quarters{dir = 4},/turf/open/floor/plasteel/dark,/area/ship/hallway/central)
"LU" = (/obj/machinery/atmospherics/components/unary/vent_pump/on/layer2,/obj/structure/chair/comfy/shuttle{dir = 1},/turf/open/floor/mineral/plastitanium,/area/ship/bridge)
"MC" = (/obj/machinery/door/window/survival_pod{dir = 1},/obj/structure/fans/tiny,/turf/open/floor/plasteel/telecomms_floor,/area/ship/engineering)
"Nf" = (/obj/machinery/door/airlock/survival_pod{name = "Bedroom"; dir = 4},/obj/structure/cable{icon_state = "4-8"},/obj/machinery/atmospherics/pipe/simple/scrubbers/hidden/layer4{dir = 4},/obj/machinery/atmospherics/pipe/simple/supply/hidden/layer2{dir = 4},/turf/open/floor/plasteel/mono/dark,/area/ship/crew)
"NU" = (/obj/structure/cable{icon_state = "0-6"},/obj/structure/cable{icon_state = "0-10"},/obj/machinery/power/apc/auto_name/directional/south,/turf/open/floor/mineral/plastitanium,/area/ship/bridge)
"Ol" = (/obj/structure/table/abductor,/obj/machinery/airalarm/directional/west,/turf/open/floor/plasteel/dark,/area/ship/storage/eva)
"Oq" = (/obj/machinery/portable_atmospherics/canister/oxygen,/obj/effect/turf_decal/corner/opaque/black/half{dir = 8},/obj/effect/turf_decal/corner/opaque/black/bordercorner,/obj/machinery/atmospherics/components/unary/portables_connector/visible/layer2{dir = 4},/turf/open/floor/plasteel/tech,/area/ship/engineering)
"Os" = (/obj/effect/turf_decal/corner/opaque/solgovblue/half{dir = 4},/obj/machinery/airalarm/directional/east,/turf/open/floor/plasteel/dark,/area/ship/hallway/central)
"Pw" = (/obj/structure/table/abductor,/obj/item/eter_violet,/turf/open/floor/plating/abductor,/area/ship/archonic)
"PN" = (/obj/item/implantpad,/obj/structure/table/abductor,/obj/item/clothing/neck/crystal_amulet/archous/stayofexecution,/turf/open/floor/plasteel/dark,/area/ship/crew)
"Qe" = (/obj/machinery/airalarm/directional/east,/turf/open/floor/plasteel/dark,/area/ship/crew)
"Qo" = (/obj/effect/turf_decal/corner/opaque/black/mono,/turf/open/floor/plasteel/tech,/area/ship/engineering)
"QD" = (/obj/machinery/computer/camera_advanced{dir = 4; icon = 'icons/obj/abductor.dmi'; icon_state = "camera"; icon_screen = null; icon_keyboard = null},/turf/open/floor/plating/abductor,/area/ship/archonic)
"QF" = (/obj/effect/turf_decal/corner/opaque/black/bordercorner{dir = 8},/obj/machinery/atmospherics/pipe/simple/supply/hidden/layer2{dir = 9},/turf/open/floor/plasteel/tech/grid,/area/ship/engineering)
"QV" = (/obj/effect/turf_decal/corner/opaque/black/half{dir = 4},/obj/effect/turf_decal/corner/opaque/black/bordercorner{dir = 8},/turf/open/floor/plasteel/tech,/area/ship/engineering)
"Rr" = (/turf/closed/indestructible/syndicate,/area/ship/bridge)
"Rv" = (/obj/item/aicard,/obj/item/multitool/ai_detect,/obj/item/malf_upgrade,/obj/effect/turf_decal/corner/opaque/black/half,/obj/effect/turf_decal/corner/opaque/black/bordercorner{dir = 4},/obj/structure/table/abductor,/turf/open/floor/plasteel/tech,/area/ship/engineering)
"RS" = (/obj/item/storage/toolbox/syndicate,/obj/item/stock_parts/cell/bluespace,/obj/item/stock_parts/cell/bluespace,/obj/item/stock_parts/cell/bluespace,/obj/machinery/light/directional/north,/obj/machinery/atmospherics/pipe/simple/scrubbers/hidden/layer4{dir = 10},/obj/machinery/atmospherics/pipe/simple/supply/hidden/layer2{dir = 10},/obj/effect/turf_decal/corner/opaque/black/half{dir = 1},/obj/effect/turf_decal/corner/opaque/black/bordercorner{dir = 8},/obj/structure/table/abductor,/turf/open/floor/plasteel/tech,/area/ship/engineering)
"Sd" = (/obj/machinery/door/poddoor/shutters/indestructible{id = "termcshutter"},/turf/closed/indestructible/opsglass,/area/ship/bridge)
"Tv" = (/turf/closed/indestructible/alien,/area/ship/medical)
"TZ" = (/obj/machinery/atmospherics/components/unary/vent_pump/on/layer2{dir = 1},/turf/open/floor/mineral/abductor,/area/ship/archonic)
"Uo" = (/obj/structure/lattice/catwalk,/obj/structure/grille,/turf/template_noop,/area/ship/external)
"Up" = (/obj/machinery/atmospherics/pipe/simple/supply/hidden/layer2,/turf/open/floor/mineral/plastitanium,/area/ship/bridge)
"UX" = (/obj/machinery/chem_master,/turf/open/floor/plasteel/white,/area/ship/medical)
"VX" = (/obj/machinery/atmospherics/components/unary/portables_connector/visible{dir = 4},/obj/machinery/portable_atmospherics/canister/oxygen,/turf/open/floor/plasteel/white,/area/ship/medical)
"Wb" = (/obj/structure/table/abductor,/obj/item/radio/intercom/wideband/table{dir = 1},/turf/open/floor/mineral/plastitanium,/area/ship/bridge)
"Wh" = (/obj/structure/cable,/obj/machinery/power/apc/auto_name/directional/east,/turf/open/floor/plasteel/dark,/area/ship/crew)
"Wn" = (/obj/machinery/door/airlock/survival_pod/glass{name = "Medical Bay"; dir = 4},/obj/structure/cable{icon_state = "4-8"},/obj/machinery/atmospherics/pipe/simple/supply/hidden/layer2{dir = 4},/obj/machinery/atmospherics/pipe/simple/scrubbers/hidden/layer4{dir = 4},/turf/open/floor/plasteel/mono/dark,/area/ship/medical)
"Wx" = (/obj/machinery/atmospherics/pipe/simple/scrubbers/hidden/layer4,/obj/machinery/atmospherics/pipe/simple/supply/hidden/layer2,/obj/effect/turf_decal/corner/opaque/black/bordercorner{dir = 1},/turf/open/floor/plasteel/tech/grid,/area/ship/engineering)
"WL" = (/obj/machinery/atmospherics/pipe/simple/scrubbers/hidden/layer4{dir = 9},/obj/machinery/atmospherics/pipe/simple/supply/hidden/layer2{dir = 10},/turf/open/floor/plasteel/dark,/area/ship/storage/eva)
"Xp" = (/obj/machinery/computer/communications,/turf/open/floor/mineral/plastitanium,/area/ship/bridge)
"Xq" = (/obj/structure/table/abductor,/obj/item/archonic/interface_system,/obj/item/clothing/neck/crystal_amulet/archous/stayofexecution,/turf/open/floor/plating/abductor,/area/ship/archonic)
"XX" = (/turf/closed/indestructible/syndicate,/area/ship/hallway/central)
"Yy" = (/obj/machinery/computer{icon_keyboard = null; icon_screen = null; icon = 'icons/obj/stationobjs.dmi'; icon_state = "blackbox_b"; name = "Apotheosis Project"},/turf/open/floor/plasteel/telecomms_floor,/area/ship/engineering)
"YH" = (/obj/structure/table/abductor,/turf/open/floor/mineral/plastitanium,/area/ship/bridge)
"Zd" = (/obj/machinery/atmospherics/pipe/simple/scrubbers/hidden/layer4{dir = 5},/obj/machinery/atmospherics/pipe/manifold/supply/hidden/layer2{dir = 4},/turf/open/floor/plasteel/tech/grid,/area/ship/engineering)
"ZX" = (/turf/open/floor/plasteel/dark,/area/ship/crew)

(1,1,1) = {"
xUxUxUxURrSdSdSdSdSdSdSdRrxUxUxUxU
xUxUxUxUcHYHWbyOBlXpiUYHiQxUxUxUxU
xUxUxUxURrYHyMugyMLUyMYHRrxUxUxUxU
xUxUxULtRrRrybzwNUUpHqRrRrLtxUxUxU
xUxUxULtxURrRriGRrAYRrRrxULtxUxUxU
xUxUxULtxUxUXXLCvsebXXxUxULtxUxUxU
xUititititititzxldmjcxcxcxcxcxcxxU
xUDNJkZXnTJfitHItPIkcxyElplplpcxxU
xUDNZXZXlSQeitlYtPHTcxOlHHAyAytQLj
xUitpQZXfYGQNfKzJIJJuYjQWLAyLlcxxU
xUitrbZXFJWhitlYvgHTcxksmWAymgcxxU
xUitwJeBPNJgitHIvgIkcxAyAyAymgcxxU
anananananananlYvgOscdcdcdcdcdcdcd
anjAjAfeHdkFWnyJxGmZzyyKgpRSgblgcd
anydydeUydananioKSiocdcdbTWxcGzVcd
anrmDcbviaaniohPGhxsiocdtUZdqOlecd
anVXydydydanQDTZKPbSPwcdOqQFeVQVcd
anclydydydanBdlMswlMXqcdgNnyRvQocd
anJDydydxnaniolMIRlMiocdlzlzlzMCcd
anUXGeqDcIanioioioioiocdkmilYyHBcd
anAKAKAKAKanUoUoUoUoUocdIHIHIHIHcd
anTvjIjITvanxUxUxUxUxUcdchAxAxchcd
anTvhRhRTvanxUxUxUxUxUcdchfCfCchcd
"}
