"an" = (/turf/closed/indestructible/alien,/area/ship/engineering)
"aG" = (/obj/effect/turf_decal/corner/opaque/solgovblue/half{dir = 8},/turf/open/floor/plasteel/dark,/area/ship/hallway/central)
"aN" = (/turf/open/floor/mineral/abductor,/area/ship/archonic)
"cl" = (/obj/structure/grille,/obj/structure/lattice/catwalk,/turf/template_noop,/area/ship/external)
"cz" = (/turf/template_noop,/area/template_noop)
"cA" = (/obj/structure/fans/tiny,/obj/machinery/door/namedoor{dir = 8; name = "Terminal Access Point"},/obj/docking_port/mobile{can_move_docking_ports = 1; dir = 8; launch_status = 0; port_direction = 4},/turf/open/floor/plating,/area/ship/storage/eva)
"cQ" = (/obj/structure/cable{icon_state = "4-8"},/obj/machinery/atmospherics/pipe/simple/supply/hidden/layer2{dir = 4},/obj/machinery/atmospherics/pipe/simple/scrubbers/hidden/layer4{dir = 4},/obj/effect/turf_decal/corner/opaque/solgovblue/three_quarters,/turf/open/floor/plasteel/dark,/area/ship/hallway/central)
"cY" = (/obj/machinery/chem_master,/turf/open/floor/plasteel/white,/area/ship/medical)
"cZ" = (/obj/machinery/telecomms/allinone,/turf/open/floor/plasteel/telecomms_floor,/area/ship/engineering)
"do" = (/obj/machinery/door/poddoor/shutters/indestructible{dir = 4; id = "termbedshutter"},/turf/closed/indestructible/opsglass,/area/ship/crew)
"ds" = (/obj/structure/cable{icon_state = "1-6"},/obj/machinery/atmospherics/pipe/simple/scrubbers/hidden/layer4,/obj/effect/turf_decal/corner/opaque/solgovblue/three_quarters{dir = 4},/turf/open/floor/plasteel/dark,/area/ship/hallway/central)
"dV" = (/obj/machinery/light/directional/east,/obj/effect/turf_decal/corner/opaque/solgovblue/half{dir = 4},/turf/open/floor/plasteel/dark,/area/ship/hallway/central)
"eg" = (/turf/open/floor/mineral/plastitanium,/area/ship/bridge)
"en" = (/obj/machinery/computer/helm,/turf/open/floor/mineral/plastitanium,/area/ship/bridge)
"es" = (/obj/structure/cable{icon_state = "1-8"},/obj/structure/cable{icon_state = "4-8"},/obj/machinery/atmospherics/pipe/simple/scrubbers/hidden/layer4{dir = 5},/obj/machinery/atmospherics/pipe/simple/supply/hidden/layer2{dir = 9},/turf/open/floor/mineral/abductor,/area/ship/archonic)
"ex" = (/obj/machinery/atmospherics/pipe/simple/scrubbers/hidden/layer4,/obj/machinery/atmospherics/pipe/simple/supply/hidden/layer2,/obj/effect/turf_decal/corner/opaque/black/bordercorner{dir = 1},/turf/open/floor/plasteel/tech/grid,/area/ship/engineering)
"eM" = (/obj/structure/table/abductor,/obj/machinery/button/door{id = "termcshutter"; name = "Cockpit Shutters"},/turf/open/floor/mineral/plastitanium,/area/ship/bridge)
"eY" = (/turf/closed/indestructible/syndicate,/area/ship/medical)
"fW" = (/obj/item/implantpad,/obj/structure/table/abductor,/obj/item/clothing/neck/crystal_amulet/archous/stayofexecution,/turf/open/floor/plasteel/dark,/area/ship/crew)
"gM" = (/obj/structure/window/reinforced/survival_pod/spawner/north,/turf/closed/indestructible/alien,/area/ship/medical)
"gX" = (/obj/structure/window/reinforced/survival_pod/spawner/north,/turf/closed/indestructible/alien,/area/ship/engineering)
"hF" = (/obj/machinery/light/directional/west,/obj/effect/turf_decal/corner/opaque/solgovblue/half{dir = 8},/turf/open/floor/plasteel/dark,/area/ship/hallway/central)
"hX" = (/obj/effect/turf_decal/corner/opaque/solgovblue/half{dir = 1},/turf/open/floor/plasteel/dark,/area/ship/hallway/central)
"iH" = (/obj/machinery/atmospherics/components/unary/vent_pump/on/layer2{dir = 4},/obj/effect/turf_decal/corner/opaque/black/half{dir = 8},/obj/machinery/mission_scanner,/turf/open/floor/plasteel/tech,/area/ship/engineering)
"iK" = (/obj/machinery/portable_atmospherics/canister/oxygen,/obj/effect/turf_decal/corner/opaque/black/half{dir = 8},/obj/effect/turf_decal/corner/opaque/black/bordercorner,/obj/machinery/atmospherics/components/unary/portables_connector/visible/layer2{dir = 4},/turf/open/floor/plasteel/tech,/area/ship/engineering)
"jb" = (/obj/machinery/light/directional/south,/turf/open/floor/mineral/plastitanium,/area/ship/bridge)
"jH" = (/turf/closed/indestructible/syndicate,/area/ship/engineering)
"jY" = (/obj/machinery/light/directional/east,/obj/machinery/atmospherics/components/unary/vent_pump/on/layer2{dir = 8},/turf/open/floor/plasteel/white,/area/ship/medical)
"kt" = (/obj/machinery/atmospherics/pipe/simple/scrubbers/hidden/layer4{dir = 5},/obj/machinery/atmospherics/pipe/manifold/supply/hidden/layer2{dir = 4},/turf/open/floor/plasteel/tech/grid,/area/ship/engineering)
"lv" = (/obj/machinery/computer{icon = 'icons/obj/stationobjs.dmi'; icon_keyboard = null; icon_screen = null; icon_state = "blackbox"; name = "Three Pointed Star Archives"},/turf/open/floor/plasteel/telecomms_floor,/area/ship/engineering)
"lL" = (/obj/machinery/atmospherics/pipe/simple/scrubbers/hidden/layer4{dir = 5},/obj/machinery/atmospherics/pipe/simple/supply/hidden/layer2{dir = 6},/turf/open/floor/plasteel/dark,/area/ship/crew)
"mB" = (/turf/closed/indestructible/syndicate,/area/ship/hallway/central)
"mG" = (/obj/structure/table/abductor,/obj/item/multitool/abductor,/turf/open/floor/plating/abductor,/area/ship/archonic)
"mV" = (/obj/machinery/computer/camera_advanced/syndie,/turf/open/floor/mineral/plastitanium,/area/ship/bridge)
"mY" = (/obj/machinery/light/directional/south,/obj/machinery/airalarm/directional/west,/turf/open/floor/mineral/plastitanium,/area/ship/bridge)
"nf" = (/obj/machinery/atmospherics/pipe/simple/supply/hidden/layer2{dir = 9},/obj/effect/turf_decal/corner/opaque/solgovblue/half{dir = 4},/turf/open/floor/plasteel/dark,/area/ship/hallway/central)
"nh" = (/obj/machinery/rnd/server,/obj/effect/turf_decal/corner/opaque/black/mono,/turf/open/floor/plasteel/tech,/area/ship/engineering)
"nu" = (/obj/machinery/computer/launchpad{dir = 1},/turf/open/floor/plating/abductor,/area/ship/archonic)
"nv" = (/obj/machinery/atmospherics/components/unary/vent_scrubber/on/layer4{dir = 8},/turf/open/floor/plasteel/tech/grid,/area/ship/engineering)
"nG" = (/obj/effect/turf_decal/corner/opaque/solgovblue/half{dir = 4},/turf/open/floor/plasteel/dark,/area/ship/hallway/central)
"nR" = (/obj/machinery/rnd/production/techfab,/obj/effect/turf_decal/corner/opaque/black/mono,/turf/open/floor/plasteel/tech,/area/ship/engineering)
"oi" = (/turf/closed/indestructible/syndicate,/area/ship/storage/eva)
"oo" = (/obj/machinery/atmospherics/components/unary/cryo_cell,/turf/open/floor/plasteel/white,/area/ship/medical)
"ox" = (/obj/machinery/atmospherics/components/unary/thermomachine/freezer,/turf/open/floor/plasteel/white,/area/ship/medical)
"ph" = (/turf/closed/indestructible/syndicate,/area/ship/bridge)
"pm" = (/obj/structure/cable{icon_state = "0-4"},/obj/machinery/atmospherics/pipe/simple/supply/hidden/layer2{dir = 4},/obj/machinery/atmospherics/pipe/simple/scrubbers/hidden/layer4{dir = 4},/obj/machinery/power/apc/auto_name/directional/north,/turf/open/floor/plasteel/stairs{dir = 8},/area/ship/medical)
"pF" = (/obj/machinery/door/poddoor/shutters/indestructible{id = "termcshutter"},/turf/closed/indestructible/opsglass,/area/ship/bridge)
"pI" = (/obj/machinery/door/airlock/abductor{name = "Reliquary"},/obj/structure/cable{icon_state = "1-2"},/obj/machinery/atmospherics/pipe/simple/scrubbers/hidden/layer4,/turf/open/floor/plasteel/mono/dark,/area/ship/archonic)
"pL" = (/obj/machinery/atmospherics/pipe/simple/scrubbers/hidden/layer4{dir = 4},/obj/machinery/atmospherics/pipe/simple/supply/hidden/layer2{dir = 4},/obj/effect/turf_decal/corner/opaque/black/mono,/obj/machinery/airalarm/directional/north,/turf/open/floor/plasteel/tech,/area/ship/engineering)
"qA" = (/turf/closed/indestructible/syndicate,/area/ship/crew)
"qD" = (/obj/structure/cable{icon_state = "0-8"},/obj/machinery/power/apc/auto_name/directional/north,/obj/machinery/atmospherics/pipe/simple/scrubbers/hidden/layer4{dir = 10},/obj/machinery/airalarm/directional/east,/turf/open/floor/mineral/abductor,/area/ship/archonic)
"qS" = (/obj/machinery/door/poddoor/shutters/indestructible{id = "termcshutter"; dir = 4},/turf/closed/indestructible/opsglass,/area/ship/bridge)
"qV" = (/obj/machinery/atmospherics/pipe/simple/supply/hidden/layer2,/turf/open/floor/mineral/plastitanium,/area/ship/bridge)
"rD" = (/obj/structure/table/abductor,/obj/machinery/airalarm/directional/west,/turf/open/floor/plasteel/dark,/area/ship/storage/eva)
"rL" = (/obj/machinery/light/directional/east,/obj/structure/chair/comfy/shuttle{dir = 8},/turf/open/floor/plasteel/dark,/area/ship/storage/eva)
"sf" = (/obj/machinery/suit_storage_unit/inherit,/obj/item/tank/internals/emergency_oxygen/double,/obj/item/clothing/mask/nobreath,/obj/item/clothing/suit/space/hardsuit/quixote/dimensional,/turf/open/floor/plasteel/dark,/area/ship/storage/eva)
"sR" = (/turf/open/floor/plasteel/dark,/area/ship/storage/eva)
"us" = (/obj/structure/dresser,/obj/item/flashlight/lantern/lamp_of_silence{pixel_y = 14; pixel_x = -2},/turf/open/floor/plasteel/dark,/area/ship/crew)
"uC" = (/obj/machinery/atmospherics/pipe/simple/scrubbers/hidden/layer4{dir = 9},/obj/machinery/atmospherics/pipe/simple/supply/hidden/layer2{dir = 5},/turf/open/floor/plasteel/white,/area/ship/medical)
"ve" = (/obj/machinery/chem_heater,/turf/open/floor/plasteel/white,/area/ship/medical)
"vB" = (/obj/structure/cable,/obj/machinery/power/apc/auto_name/directional/east,/turf/open/floor/plasteel/dark,/area/ship/crew)
"vK" = (/obj/machinery/light/directional/west,/turf/open/floor/plasteel/dark,/area/ship/crew)
"xc" = (/obj/structure/cable{icon_state = "4-8"},/obj/machinery/atmospherics/pipe/simple/scrubbers/hidden/layer4{dir = 4},/obj/machinery/atmospherics/pipe/simple/supply/hidden/layer2{dir = 4},/obj/effect/turf_decal/corner/opaque/solgovblue/half{dir = 4},/turf/open/floor/plasteel/dark,/area/ship/hallway/central)
"xl" = (/obj/machinery/airalarm/directional/east,/turf/open/floor/plasteel/dark,/area/ship/crew)
"xG" = (/obj/structure/table/reinforced,/turf/open/floor/plasteel/white,/area/ship/medical)
"xV" = (/obj/item/storage/toolbox/syndicate,/obj/item/stock_parts/cell/bluespace,/obj/item/stock_parts/cell/bluespace,/obj/item/stock_parts/cell/bluespace,/obj/machinery/light/directional/north,/obj/machinery/atmospherics/pipe/simple/scrubbers/hidden/layer4{dir = 10},/obj/machinery/atmospherics/pipe/simple/supply/hidden/layer2{dir = 10},/obj/effect/turf_decal/corner/opaque/black/half{dir = 1},/obj/effect/turf_decal/corner/opaque/black/bordercorner{dir = 8},/obj/structure/table/abductor,/turf/open/floor/plasteel/tech,/area/ship/engineering)
"xW" = (/obj/structure/cable{icon_state = "2-4"},/obj/machinery/atmospherics/pipe/simple/scrubbers/hidden/layer4{dir = 4},/obj/machinery/atmospherics/pipe/simple/supply/hidden/layer2{dir = 4},/turf/open/floor/plasteel/dark,/area/ship/crew)
"yc" = (/obj/effect/turf_decal/corner/opaque/black/half{dir = 4},/turf/open/floor/plasteel/tech,/area/ship/engineering)
"yC" = (/obj/machinery/door/airlock/survival_pod{name = "Bedroom"; dir = 4},/obj/structure/cable{icon_state = "4-8"},/obj/machinery/atmospherics/pipe/simple/scrubbers/hidden/layer4{dir = 4},/obj/machinery/atmospherics/pipe/simple/supply/hidden/layer2{dir = 4},/turf/open/space/basic,/area/ship/crew)
"yH" = (/obj/structure/table/abductor,/obj/item/eter_violet,/turf/open/floor/plating/abductor,/area/ship/archonic)
"yZ" = (/obj/structure/cable,/obj/machinery/power/apc/auto_name/directional/west,/turf/open/floor/plasteel/dark,/area/ship/storage/eva)
"zh" = (/obj/machinery/recharge_station,/obj/effect/turf_decal/corner/opaque/black/half,/obj/effect/turf_decal/corner/opaque/black/bordercorner{dir = 1},/turf/open/floor/plasteel/tech,/area/ship/engineering)
"zK" = (/obj/item/bedsheet/double/rd,/obj/structure/bed/double,/turf/open/floor/plasteel/dark,/area/ship/crew)
"Af" = (/obj/structure/table/reinforced,/obj/machinery/atmospherics/pipe/simple/scrubbers/hidden/layer4{dir = 6},/obj/machinery/atmospherics/pipe/simple/supply/hidden/layer2{dir = 6},/obj/item/storage/firstaid/tactical,/obj/item/storage/firstaid/advanced,/obj/item/storage/firstaid/medical,/obj/item/storage/firstaid/radiation,/obj/item/storage/firstaid/toxin,/obj/effect/turf_decal/industrial/firstaid/cee,/turf/open/floor/plasteel/white,/area/ship/medical)
"Ag" = (/turf/open/floor/plasteel/rockvault/alien,/area/ship/engineering)
"Bb" = (/obj/machinery/computer/camera_advanced{dir = 4; icon = 'icons/obj/abductor.dmi'; icon_state = "camera"; icon_screen = null; icon_keyboard = null},/turf/open/floor/plating/abductor,/area/ship/archonic)
"Co" = (/obj/machinery/door/airlock/survival_pod/glass{name = "EVA"; dir = 8},/obj/structure/cable{icon_state = "4-8"},/obj/machinery/atmospherics/pipe/simple/scrubbers/hidden/layer4{dir = 4},/obj/machinery/atmospherics/pipe/simple/supply/hidden/layer2{dir = 4},/turf/open/space/basic,/area/ship/storage/eva)
"CE" = (/turf/open/floor/plasteel/white,/area/ship/medical)
"CM" = (/obj/machinery/door/airlock/survival_pod{name = "Bridge"},/obj/structure/cable{icon_state = "2-5"},/obj/machinery/atmospherics/pipe/simple/scrubbers/hidden/layer4,/turf/open/floor/mineral/plastitanium,/area/ship/bridge)
"Db" = (/obj/machinery/chem_dispenser/abductor,/turf/open/floor/plasteel/white,/area/ship/medical)
"De" = (/obj/machinery/atmospherics/components/unary/vent_scrubber/on/layer4,/obj/structure/chair/comfy/shuttle{dir = 1},/turf/open/floor/mineral/plastitanium,/area/ship/bridge)
"Dl" = (/obj/structure/cable{icon_state = "1-2"},/obj/structure/cable{icon_state = "2-8"},/obj/structure/cable{icon_state = "2-4"},/obj/machinery/atmospherics/pipe/manifold4w/scrubbers/hidden/layer4,/obj/machinery/atmospherics/pipe/manifold4w/supply/hidden/layer2,/obj/effect/turf_decal/corner/opaque/solgovblue/half,/turf/open/floor/plasteel/dark,/area/ship/hallway/central)
"Dm" = (/obj/structure/chair/comfy/shuttle{dir = 8},/turf/open/floor/plasteel/dark,/area/ship/storage/eva)
"Dr" = (/obj/item/storage/secure/briefcase,/obj/structure/table/abductor,/turf/open/floor/plasteel/dark,/area/ship/crew)
"DI" = (/obj/machinery/door/airlock/survival_pod{name = "Bridge"},/obj/structure/cable{icon_state = "2-9"},/obj/machinery/atmospherics/pipe/simple/supply/hidden/layer2,/turf/open/floor/mineral/plastitanium,/area/ship/bridge)
"Ea" = (/obj/machinery/atmospherics/components/unary/vent_pump/on/layer2{dir = 1},/turf/open/floor/plasteel/dark,/area/ship/crew)
"Ec" = (/obj/machinery/power/shuttle/engine/void,/turf/open/floor/plating,/area/ship/medical)
"El" = (/obj/machinery/atmospherics/components/unary/vent_pump/on/layer2{dir = 1},/turf/open/floor/plasteel/dark,/area/ship/storage/eva)
"EF" = (/turf/open/floor/plasteel/dark,/area/ship/crew)
"ES" = (/obj/machinery/atmospherics/pipe/simple/scrubbers/hidden/layer4{dir = 5},/obj/effect/turf_decal/corner/opaque/solgovblue/half{dir = 8},/turf/open/floor/plasteel/dark,/area/ship/hallway/central)
"Fw" = (/turf/open/floor/plasteel/rockvault/alien,/area/ship/medical)
"FA" = (/obj/structure/table/abductor,/turf/open/floor/plasteel/dark,/area/ship/storage/eva)
"FP" = (/obj/machinery/atmospherics/pipe/simple/scrubbers/hidden/layer4{dir = 4},/obj/machinery/atmospherics/pipe/simple/supply/hidden/layer2{dir = 4},/obj/machinery/airalarm/directional/north,/turf/open/floor/plasteel/white,/area/ship/medical)
"FQ" = (/obj/structure/cable{icon_state = "2-8"},/obj/structure/cable{icon_state = "2-4"},/obj/structure/cable{icon_state = "1-2"},/obj/machinery/atmospherics/pipe/manifold4w/scrubbers/hidden/layer4,/obj/machinery/atmospherics/pipe/manifold4w/supply/hidden/layer2,/turf/open/floor/plating/catwalk_floor,/area/ship/hallway/central)
"GE" = (/turf/open/floor/plating/abductor,/area/ship/archonic)
"Ho" = (/obj/structure/cable{icon_state = "2-5"},/obj/structure/cable{icon_state = "2-9"},/obj/machinery/atmospherics/pipe/simple/supply/hidden/layer2{dir = 6},/obj/machinery/atmospherics/pipe/simple/scrubbers/hidden/layer4{dir = 10},/turf/open/floor/plating/catwalk_floor,/area/ship/hallway/central)
"Hx" = (/obj/effect/turf_decal/corner/opaque/black/bordercorner{dir = 8},/obj/machinery/atmospherics/pipe/simple/supply/hidden/layer2{dir = 9},/turf/open/floor/plasteel/tech/grid,/area/ship/engineering)
"HC" = (/obj/machinery/atmospherics/components/unary/vent_scrubber/on/layer4,/turf/open/floor/plasteel/dark,/area/ship/storage/eva)
"Iw" = (/turf/closed/indestructible/syndicate,/area/ship/archonic)
"IG" = (/obj/machinery/computer/communications,/turf/open/floor/mineral/plastitanium,/area/ship/bridge)
"Ju" = (/obj/machinery/button/door{dir = 4; pixel_y = 6; pixel_x = -22; id = "termbedshutter"; name = "Privacy Shutters"},/turf/open/floor/plasteel/dark,/area/ship/crew)
"JB" = (/obj/machinery/atmospherics/pipe/simple/scrubbers/hidden/layer4{dir = 9},/obj/machinery/atmospherics/pipe/simple/supply/hidden/layer2{dir = 10},/turf/open/floor/plasteel/dark,/area/ship/storage/eva)
"JC" = (/obj/item/aicard,/obj/item/multitool/ai_detect,/obj/item/malf_upgrade,/obj/effect/turf_decal/corner/opaque/black/half,/obj/effect/turf_decal/corner/opaque/black/bordercorner{dir = 4},/obj/structure/table/abductor,/turf/open/floor/plasteel/tech,/area/ship/engineering)
"JZ" = (/obj/machinery/atmospherics/components/unary/portables_connector/visible{dir = 4},/obj/machinery/portable_atmospherics/canister/oxygen,/turf/open/floor/plasteel/white,/area/ship/medical)
"KQ" = (/obj/effect/turf_decal/corner/opaque/black/bordercorner{dir = 4},/turf/open/floor/plasteel/tech/grid,/area/ship/engineering)
"Lb" = (/obj/structure/cable{icon_state = "1-10"},/obj/machinery/atmospherics/pipe/simple/supply/hidden/layer2,/obj/effect/turf_decal/corner/opaque/solgovblue/three_quarters{dir = 8},/turf/open/floor/plasteel/dark,/area/ship/hallway/central)
"Lg" = (/obj/structure/cable{icon_state = "4-8"},/obj/machinery/atmospherics/pipe/simple/supply/hidden/layer2{dir = 4},/obj/machinery/atmospherics/pipe/simple/scrubbers/hidden/layer4{dir = 4},/obj/effect/turf_decal/corner/opaque/solgovblue/three_quarters{dir = 1},/turf/open/floor/plasteel/dark,/area/ship/hallway/central)
"Lq" = (/obj/structure/table/reinforced,/obj/item/wrench/medical,/obj/machinery/light/directional/west,/turf/open/floor/plasteel/white,/area/ship/medical)
"LJ" = (/obj/structure/lattice/catwalk,/obj/structure/grille,/turf/template_noop,/area/ship/external)
"Mb" = (/obj/machinery/atmospherics/components/unary/vent_scrubber/on/layer4{dir = 4},/turf/open/floor/plasteel/white,/area/ship/medical)
"Mg" = (/obj/structure/table/abductor,/obj/item/archonic/interface_system,/obj/item/clothing/neck/crystal_amulet/archous/stayofexecution,/turf/open/floor/plating/abductor,/area/ship/archonic)
"MQ" = (/obj/machinery/door/window/survival_pod{dir = 1},/obj/structure/fans/tiny,/turf/open/floor/plasteel/telecomms_floor,/area/ship/engineering)
"Nb" = (/obj/structure/cable{icon_state = "0-6"},/obj/structure/cable{icon_state = "0-10"},/obj/machinery/power/apc/auto_name/directional/south,/turf/open/floor/mineral/plastitanium,/area/ship/bridge)
"ND" = (/obj/machinery/atmospherics/pipe/simple/scrubbers/hidden/layer4,/obj/machinery/atmospherics/pipe/simple/supply/hidden/layer2,/turf/open/floor/plasteel/white,/area/ship/medical)
"Ov" = (/turf/closed/indestructible/alien,/area/ship/medical)
"OG" = (/obj/machinery/atmospherics/components/unary/vent_pump/on/layer2,/obj/structure/chair/comfy/shuttle{dir = 1},/turf/open/floor/mineral/plastitanium,/area/ship/bridge)
"OM" = (/obj/structure/table/abductor,/obj/item/radio/intercom/wideband/table{dir = 1},/turf/open/floor/mineral/plastitanium,/area/ship/bridge)
"OW" = (/obj/effect/turf_decal/corner/opaque/black/half{dir = 8},/obj/effect/turf_decal/corner/opaque/black/bordercorner{dir = 4},/turf/open/floor/plasteel/tech,/area/ship/engineering)
"OY" = (/obj/docking_port/stationary{dir = 4; dwidth = 15; height = 15; width = 30},/turf/template_noop,/area/template_noop)
"Po" = (/obj/structure/cable{icon_state = "1-2"},/obj/machinery/atmospherics/pipe/simple/supply/hidden/layer2,/obj/machinery/atmospherics/pipe/simple/scrubbers/hidden/layer4,/turf/open/floor/plating/catwalk_floor,/area/ship/hallway/central)
"PW" = (/obj/structure/table/optable,/turf/open/floor/plasteel/white,/area/ship/medical)
"Qg" = (/obj/machinery/autolathe/hacked,/obj/effect/turf_decal/corner/opaque/black/half{dir = 1},/obj/effect/turf_decal/corner/opaque/black/bordercorner,/turf/open/floor/plasteel/tech,/area/ship/engineering)
"QG" = (/obj/structure/window/reinforced/survival_pod/spawner/north,/turf/open/floor/plasteel/telecomms_floor,/area/ship/engineering)
"Rc" = (/obj/effect/turf_decal/corner/opaque/black/half{dir = 4},/obj/effect/turf_decal/corner/opaque/black/bordercorner{dir = 8},/turf/open/floor/plasteel/tech,/area/ship/engineering)
"Sz" = (/obj/machinery/atmospherics/pipe/simple/scrubbers/hidden/layer4,/turf/open/floor/mineral/plastitanium,/area/ship/bridge)
"SH" = (/obj/machinery/ntnet_relay,/turf/open/floor/plasteel/telecomms_floor,/area/ship/engineering)
"SL" = (/obj/item/archonic/interface_system,/obj/structure/table/abductor,/turf/open/floor/plasteel/dark,/area/ship/crew)
"SX" = (/obj/structure/cable{icon_state = "0-8"},/obj/machinery/atmospherics/pipe/simple/supply/hidden/layer2{dir = 4},/obj/machinery/atmospherics/pipe/simple/scrubbers/hidden/layer4{dir = 4},/obj/machinery/power/apc/auto_name/directional/north,/turf/open/floor/plasteel/stairs{dir = 4},/area/ship/engineering)
"Tb" = (/obj/machinery/atmospherics/components/unary/vent_scrubber/on/layer4,/turf/open/floor/plasteel/dark,/area/ship/crew)
"Tn" = (/obj/machinery/atmospherics/components/unary/vent_scrubber/on/layer4{dir = 1},/turf/open/floor/mineral/abductor,/area/ship/archonic)
"Tu" = (/obj/machinery/launchpad/violetspace,/turf/open/floor/plating/abductor2,/area/ship/archonic)
"TA" = (/obj/structure/closet/cabinet,/obj/item/clothing/under/syndicate/skirt,/obj/item/clothing/under/syndicate/skirt/maid,/obj/item/clothing/under/syndicate/skirt/maid,/obj/item/clothing/under/syndicate/skirt/maid,/obj/item/clothing/under/syndicate/skirt,/obj/item/clothing/under/syndicate/skirt,/obj/item/clothing/under/syndicate/tacticool/skirt,/obj/item/clothing/under/syndicate/tacticool/skirt,/obj/item/clothing/under/syndicate/tacticool/skirt,/obj/item/clothing/shoes/jackboots,/obj/item/clothing/shoes/jackboots,/obj/item/clothing/shoes/jackboots,/obj/item/clothing/gloves/combat,/obj/item/clothing/gloves/combat,/obj/item/clothing/gloves/combat,/obj/item/clothing/gloves/combat/maid,/obj/item/clothing/head/maidheadband/syndicate,/turf/open/floor/plasteel/dark,/area/ship/crew)
"UC" = (/obj/structure/table/abductor,/turf/open/floor/mineral/plastitanium,/area/ship/bridge)
"Vi" = (/obj/structure/table/reinforced,/obj/item/storage/backpack/duffelbag/syndie/surgery,/turf/open/floor/plasteel/white,/area/ship/medical)
"VC" = (/obj/structure/cable{icon_state = "2-8"},/obj/machinery/atmospherics/pipe/simple/scrubbers/hidden/layer4{dir = 4},/obj/machinery/atmospherics/pipe/simple/supply/hidden/layer2{dir = 4},/turf/open/floor/plasteel/dark,/area/ship/storage/eva)
"We" = (/obj/machinery/atmospherics/components/unary/vent_pump/on/layer2{dir = 1},/turf/open/floor/mineral/abductor,/area/ship/archonic)
"WA" = (/obj/effect/turf_decal/corner/opaque/black/mono,/turf/open/floor/plasteel/tech,/area/ship/engineering)
"WZ" = (/obj/machinery/computer{icon_keyboard = null; icon_screen = null; icon = 'icons/obj/stationobjs.dmi'; icon_state = "blackbox_b"; name = "Apotheosis Project"},/turf/open/floor/plasteel/telecomms_floor,/area/ship/engineering)
"Xv" = (/obj/effect/turf_decal/corner/opaque/black/bordercorner,/turf/open/floor/plasteel/tech/grid,/area/ship/engineering)
"XD" = (/obj/machinery/door/airlock/survival_pod/glass{name = "Engineering"; dir = 8},/obj/structure/cable{icon_state = "4-8"},/obj/machinery/atmospherics/pipe/simple/supply/hidden/layer2{dir = 4},/obj/machinery/atmospherics/pipe/simple/scrubbers/hidden/layer4{dir = 4},/turf/open/floor/plasteel/mono/dark,/area/ship/engineering)
"XR" = (/obj/machinery/power/shuttle/engine/void,/turf/open/floor/plating,/area/ship/engineering)
"Ye" = (/obj/structure/closet/secure_closet/personal{req_access = null; name = "Crux's Armory"},/obj/item/healthanalyzer/rad_laser,/obj/item/multitool/ai_detect,/obj/item/clothing/suit/wizrobe/magusred/archonic,/obj/item/clothing/neck/crystal_amulet/archous,/obj/item/spear/archous,/turf/open/floor/plasteel/dark,/area/ship/crew)
"Yl" = (/obj/machinery/door/airlock/survival_pod/glass{name = "Medical Bay"; dir = 4},/obj/structure/cable{icon_state = "4-8"},/obj/machinery/atmospherics/pipe/simple/supply/hidden/layer2{dir = 4},/obj/machinery/atmospherics/pipe/simple/scrubbers/hidden/layer4{dir = 4},/turf/open/floor/plasteel/mono/dark,/area/ship/medical)
"Yp" = (/obj/effect/turf_decal/corner/opaque/black/half{dir = 4},/obj/effect/turf_decal/corner/opaque/black/bordercorner{dir = 1},/turf/open/floor/plasteel/tech,/area/ship/engineering)
"Yy" = (/obj/machinery/door/poddoor/shutters/indestructible{id = "termcshutter"; dir = 8},/turf/closed/indestructible/opsglass,/area/ship/bridge)
"YC" = (/obj/machinery/power/rtg/abductor/archonic,/obj/structure/cable{icon_state = "0-4"},/obj/machinery/atmospherics/pipe/simple/supply/hidden/layer2{dir = 6},/turf/open/floor/mineral/abductor,/area/ship/archonic)
"ZF" = (/obj/structure/cable{icon_state = "1-2"},/obj/machinery/atmospherics/pipe/simple/scrubbers/hidden/layer4,/obj/machinery/atmospherics/pipe/simple/scrubbers/hidden/layer4,/obj/machinery/atmospherics/pipe/simple/supply/hidden/layer2,/turf/open/floor/plating/catwalk_floor,/area/ship/hallway/central)
"ZT" = (/obj/structure/cable{icon_state = "4-8"},/obj/machinery/atmospherics/pipe/simple/scrubbers/hidden/layer4{dir = 4},/obj/machinery/atmospherics/pipe/simple/supply/hidden/layer2{dir = 4},/obj/effect/turf_decal/corner/opaque/solgovblue/half{dir = 8},/turf/open/floor/plasteel/dark,/area/ship/hallway/central)

(1,1,1) = {"
czczczczphpFpFpFpFpFpFpFphczczczcz
czczczczqSUCOMmVenIGeMUCYyczczczcz
czczczczphUCegDeegOGegUCphczczczcz
czczczclphphmYSzNbqVjbphphclczczcz
czczczclczphphCMphDIphphczclczczcz
czczczclczczmBdshXLbmBczczclczczcz
czqAqAqAqAqAqAESHonfoioioioioioicz
czdozKEFTAusqAhFPodVoiFAsfsfsfoicz
czdoEFEFTbxlqAaGPonGoirDHCsRsRcAOY
czqAJuEFlLxWyCZTFQxcCoVCJBsRrLoicz
czqAvKEFEavBqAaGZFnGoiyZElsRDmoicz
czqASLDrfWYeqAhFZFdVoisRsRsRDmoicz
eYeYeYeYeYeYeYaGZFnGjHjHjHjHjHjHjH
eYooooAfFPpmYlLgDlcQXDSXpLxVQgnRjH
eYCECENDCEeYeYIwpIIwjHjHOWexKQYpjH
eYoxMbuCjYeYIwYCesqDIwjHiHktnvycjH
eYJZCECECEeYBbWeaNTnyHjHiKHxXvRcjH
eYLqCECECEeYmGGEnuGEMgjHnhzhJCWAjH
eYDbCECEveeYIwGETuGEIwjHQGQGQGMQjH
eYcYxGPWVieYIwIwIwIwIwjHcZlvWZSHjH
eYgMgMgMgMeYLJLJLJLJLJjHgXgXgXgXjH
eYOvEcEcOveYczczczczczjHanXRXRanjH
eYOvFwFwOveYczczczczczjHanAgAganjH
"}
